冯小平	M
张锁利	F
魏保保	M
单兴槐	M
张羽	F
朱海军	M
王伏香	F
金雅岩	F
鲍君芬	F
袁继	M
倪双	M
吴林彬	M
单立洋	M
尹翔天	M
古吉勇	M
喻恒江	M
朱立波	M
徐长风	M
张晓龙	M
朱庆	M
吴井秀	F
张静	F
沈雪	F
陶旭晨	M
孙天祺	M
文金芳	F
陈波蓉	F
凡小春	M
陈威岩	M
陆毅	M
张玲	F
储卜源	M
常珠凤	F
翟慧惠	F
钟艳伟	F
李淑芬	F
王晓旭	F
周菊含	F
袁浩民	M
刘兰芳	F
边龙龙	M
袁玮	F
许飞	M
邹莎	F
张磊	M
王安	M
张成锁	M
罗尚文	M
周洋	M
章东栋	M
黄军	M
陈杰	M
吕志元	M
范静	F
张禹	M
邬漫雪	F
汪排枝	F
梁庆忠	M
张木发	M
王芳	F
苟普程	M
胡彬	M
朱玲清	M
何庆明	M
刘洪文	F
徐健	M
成铁	M
蒋昭	F
王朋	M
童丽萍	F
郑根	M
张彦皊	F
熊伟	M
王增强	M
朱广秀	F
陈晓	M
彭柳英	F
王亚芬	F
王晓会	F
冉启美	F
吕冬梅	F
梁雯	F
贺强	M
罗爱光	M
冯蓓蕾	F
邵丽凤	F
邵琼芝	F
王金亭	F
舒豪	M
于雷	M
刘颖	M
余晓丽	F
丁春琳	F
王格	F
方羽翔	M
陈巧燕	F
闻雪华	M
杨克新	F
康有财	M
何艳祯	F
穆其伦	M
张伟捷	M
尚彬	M
唐桃	F
钱淑娟	F
杨中建	M
邓志	M
郑英	F
陈厚萍	F
王锋	M
孙宏治	M
李娜	F
王慧琼	F
纪团结	M
励琴芳	F
郑东旭	M
罗金凤	F
林文博	M
吴爱利	F
杨芳	F
苏浩浩	M
张中奇	M
贾静	F
李文勇	M
朱俊峰	M
程为杰	M
王立贝	M
王春斌	M
谢义明	M
许宏	M
陶国亮	M
闻伟	M
陈盼	F
杨绪发	M
张善凤	F
卫守俊	M
刘永乐	M
毛强生	M
郭前雨	M
高笛	M
王亚男	F
李红	F
姚宁波	M
于美玲	F
范秋荣	F
侯亚军	F
朱东冬	M
李根平	M
陈学静	F
卓安	M
魏朝阳	M
赵容	F
裴志龙	M
李艳梅	F
黄建芳	F
王蕊	F
李贺鹏	M
王聪	M
黄小伟	M
张红义	M
公晶	M
陈苓玲	F
徐银杰	M
方媛	F
朱玉东	M
任爱爱	F
喻斌	F
董菊	F
杨艳华	F
蔡玲玲2	F
吴玉英	F
李贵贤	F
刘素娜	F
吴斌斌	M
毛成建	M
田婷婷	F
龙朝锋	M
杨俊	M
汪中程	M
宋冬秀	F
杨清华	F
罗文秀	F
韩福企	M
李辉	M
王功林	M
张楠	M
李平	M
杨二妮	F
胡位英	F
徐华丽	F
沈斌	M
邱人洁	M
芦瑞庆	F
何洁文	M
俞亭风	F
苏运宇	M
苑保加	M
李业锋	M
高利娜	F
于文华	M
何林辉	M
卢楚滨	M
罗红成	M
张美荣	F
马会静	F
黄焕发	M
唐菊珍	F
卢水桂	F
张升芝	F
王玉粉	F
王四妮	F
王东	M
陈阳	M
陈金	M
郑春梅	F
鲍福城	M
毛东风	M
杜保建	M
魏威威	F
杨永军	M
刘志远	M
黄玲	F
马春利	F
周志文	M
吴文山	M
孟祥贺	M
周健	M
季咏珊	F
唐水英	F
王金梅	F
张宝宝	M
陈敦科	M
胡国梅	M
周伟红	F
龚祥星	M
宋洋洋	M
卢丙娴	F
张宏飞	M
许瀚尹	F
王晓飞	M
秦琳	F
朱秀珍	F
林晨	M
崔晓峰	M
张雄	M
王勇	M
王鹤	F
吴建宾	M
何明明	M
袁宏	M
王晓蓉	F
潘祥文	M
刘伟	M
刘光辉	M
张鹅	F
龚涛涛	M
李省女	F
曾芳健	M
靳曾贵	M
潘维钧	M
韩继龙	M
熊小琴	F
刘东梅	F
王庆德	M
刘春旺	M
张海兵	M
谭萍	F
樊琛	M
刘正涛	M
涂花丽	F
毛雪梅	F
李杰	M
刘成	F
王礼元	F
吴佳红	F
谢剑	M
刘俊男	M
刘越	M
袁林生	M
孙海波	M
项川辉	M
张伟昌	M
任一凡	M
李永	M
黄顺	F
项杨雨萌	F
何婷婷	F
董柳雅	F
蔡胆霞	F
豆见女	F
王方超	F
许灵超	F
康佳丽	F
丁梦繁	F
俞莉丽	F
栾文亚	M
杨秀	F
周武	M
彭林源	M
蔡红福	M
付红军	M
梁丕韬	M
蒋建军	M
李开拓	M
韩苗苗	F
陈武展	M
刘志鹏	M
孙加豪	M
饶巍	M
程小虎	M
蓝世洁	F
张露	F
任姣姣	F
胡华玲	F
杨喜程	M
白云忠	M
周雪梅	F
梅成书	M
李龙	M
刘武祥	M
徐彬	M
陈昌友	M
赵昌民	M
王强	M
耿军	M
周伟	M
郑廷廷	M
刘珍珍	F
王夏媛	F
路振行	M
张文礼	M
张梦云	F
张瑶	F
李华	F
朱建锋	M
马京	M
胡金礼	M
卢康	M
张奇凤	F
黄广平	M
马劲	M
罗明均	M
熊乐	M
孙长勇	M
孙世宁	M
朱锐	M
王军	M
黄超玲	M
姚伦亮	M
袁作平	M
李毅芳	M
朱建春	M
郭高翔	M
王利华	F
童仕忠	M
董琴	F
顾微萍	F
陈军健	M
谢东伟	M
王美清	F
华巧燕	F
黄旭妮	F
徐宁宁	F
屈怀想	F
杨德亮	M
赵军	M
张松	M
王菲	F
崔友玉	F
莫哲民	M
张腾	M
黄春	M
陈璇玑	M
左鑫	M
黄秀梅	F
王成	M
章秋平	M
方子剑	M
王时慧	F
贺晓明	F
易洋	F
宋平	M
杨汝嘉	F
吴传舟	M
徐立力	M
贾朝阳	M
周自兰	F
孔令康	M
高攀	M
楼盛龙	M
张华	M
吴耀金	M
田彦	M
皮玉兰	F
宋紫凤	F
金福山	M
虞太军	M
耿俊洋	M
丁程林	F
刘艳杰	F
刘维龙	M
谢全会	F
谢涛	M
王彬	M
万霞	F
陈轲	M
刘宇	M
夏小根	M
欧阳剑平	M
张松俊	F
邓衍飞	M
熊菊生	M
管淑婷	F
张成杰	M
魏平	F
任小辉	M
王真真	F
王春明	M
庄浩杰	M
刘慧	F
朱银龙	M
熊长英	F
张欠欠	F
拜晓光	M
琚辉	M
范小东	M
韩风娇	F
高施平	M
邱文强	M
孙安道	M
周海	M
王志	M
陈少宁	M
温健	M
熊志华	M
孔庆瑞	M
任科滨	M
张裕	M
王佳琦	F
徐亚楠	M
汪云霞	F
程新飞	M
陈帝	M
温雪梅	F
张海燕	F
吴芬兰	F
荆玉生	M
黄灵超	M
李容	F
刘俊杰	M
徐静	M
高虹	M
张兴德	M
何益锋	M
潘绍文	M
黄腊妹	F
刘丹	F
叶昌正	M
杨磊	M
杨新梅	F
刘欣	F
杜芳	F
张建忠	M
许晓约	M
高小燕	F
许伟	F
许春艳	F
许丽波	F
柯步源	M
雷利华	M
伍元治	M
吴伟珍	F
凌飞龙	M
李娜	F
万怡兵	M
陈治平	M
李竹梅	F
马玉玲	F
张小萍	F
骆耀忠	M
江五焰	M
张亚丽	F
张国民	M
毛春红	F
李万	M
徐剑冰	F
张才生	M
石子良	M
张菊英	F
刘代红	F
李梦佳	F
石成建	M
韩友红	F
朱丽霞	F
陈雪梅	F
马春青	F
廖雪梅	F
向文文	M
段唯林	M
余小刚	M
林阳	M
孟海东	M
蒋蓓蓓	M
崔微微	F
王杰	M
陈倩	F
张辉	M
赵蒙蒙	F
杨毅	M
于元磊	M
王宇飞	M
赵生群	M
黄鹏锋	M
谢思屿	M
安孝欢	M
刘雪梅	F
李元刚	M
高丽娜	F
田维	F
沈宝良	M
林策	M
黄威欽	M
伍春燕	F
毛峥峰	M
曹实	M
龙步书	M
苏汝坤	M
金文静	F
窦玲	F
林杰珍	F
陈惠	F
唐爱青	F
任利远	M
江山	M
刘文娜	F
钱星晨	M
赵磊	M
赖方东	M
田国平	M
陆小花	F
黄丰成	M
陈天宇	M
杨刚	M
高鸿远	M
曾晓兰	F
杨玉梅	F
高莹	F
覃凌云	F
徐益能	M
陈娟	F
周立波	F
吴亚军	M
缪建定	M
傅琴亚	F
缪永祥	M
任儿	F
严华听	M
赵学军	M
叶建颖	F
崔昊龙	M
吴盛辉	M
洪岳方	M
刘一丰	M
应和华	M
杨月兴	M
王亚波	F
王成义	M
王龙兰	F
朱秀君	F
崔存月	F
王梅苏	F
刘立帆	M
求益均	M
邹文亮	M
张艳芳	F
潘东友	M
徐善军	M
董祥宁	M
周胜学	M
张洪林	M
孙峰	M
洪忠芳	M
毛如飞	M
廖秀春	F
李文清	F
张碧江	M
盛桂英	F
徐正土	M
王行芬	F
洪锡存	M
施德静	M
周国渠	M
陈波	F
吴亚波	F
凌春波	F
陈国大	M
吕小高	M
洪召波	M
陆玲波	F
吴昌高	M
陈明龙	M
朱成波	M
黄科兴	M
雷金和	M
唐勇	M
陈裕德	M
崔如瑜	F
肖伏才	M
李孟定	M
陈荣娟	F
张敏华	F
毛欢乐	F
王明亮	M
杨永定	M
李桂平	M
张亮	M
易伟	M
钟占桥	M
向付群	F
赵晓华	F
王小华	F
许宏伟	M
陈朝阳	M
黄芳	F
阮金杰	M
郑海波	M
李松平	M
郁德发	M
陈军杰	M
应利平	F
薛碧河	F
翁肇明	M
叶晓章	M
傅定昌	M
洪和意	F
鲍施芬	F
彭小平	F
徐刚健	M
吴志龙	M
郑坚江	M
陈爱妹	F
毛凯波	M
孙全友	M
张小艳	F
潘铁伟	M
陈静	F
郑江	M
俞玲娣	F
竺梁明	M
郁金宏	M
许梦梦	F
翟云峰	M
彭湘红	F
王金顺	M
洪亮	M
周国方	M
孙小怡	F
余榜双	M
王东	M
殷光璐	M
韩长胜	M
黄小春	M
张国琴	M
汪成	M
李冬柏	M
杨雪刚	M
鲍春华	M
孙宏杰	M
沈全君	M
徐马炯	M
吴伦君	M
王相钟	M
陈辉	M
谢微	F
徐伟明	M
李民	M
许真鑫	M
王君妃	F
张富弟	M
江菊芬	F
崔刘成	M
江秋儿	F
周仲剑	M
王基宁	M
章娇娜	F
董国波	M
李何菊	F
应荣平	M
叶宏杰	M
徐孟君	M
吴玉芬	F
陈成	M
蔡定春	F
王永华	M
吴锡锋	M
徐燕	F
杨侠	F
叶盛峰	M
王小波	M
干晓露	M
周伟俊	M
桂昌华	M
姚谢城	M
胡芸	F
章小满	M
金余平	M
王天健	M
申建	M
洪韩	M
黄忠强	M
张情意	F
吴煜	M
姜红娟	F
单静珠	F
陈忠波	M
牟定达	M
钟国光	M
崔锡安	M
王尧军	M
樊仁国	M
陈利军	M
刘忠明	M
杨玲波	F
张勇	M
尹伏娇	F
付春艳	F
沈海华	M
杨孟飞	M
陈君夫	M
王雪娟	F
叶锡军	M
张军浩	M
吴祥洪	M
龚丹红	F
徐波	M
王姣意	F
陈浩波	M
郑宏喜	F
王云翠	F
俞德华	M
吴意	F
吴友祥	M
何志芳	M
杨雪珍	F
黄敏霞	F
曹志芳	F
叶锡茂	M
徐锡忠	M
张承勇	M
魏晓锋	M
励吉君	F
王秀清	F
罗建斌	M
董春亚	F
唐恩位	M
王孝儿	F
吴惠清	F
李定均	M
李九康	M
陈金松	M
马意波	F
鲁永良	M
陈峰	M
李莉君	F
雷雪花	F
田艳芬	F
鲁央芬	F
胡继宏	M
金里君	M
单春飞	F
蔡志刚	M
崔鎏平	M
詹杰	M
吕翱	M
吕俊钦	M
唐芳有	M
张叶飞	F
周华芬	F
龙荣华	M
陈登定	M
陈伟力	F
刘桂容	F
彭清国	M
刘进东	M
傅安华	M
白莉琴	F
吴安福	M
张照阳	F
仇素斐	F
沈宝良	M
缪如君	M
崔岳定	M
崔勇涛	M
孔新娟	F
彭子影	M
练高夫	M
陈飞	F
罗来神	M
杨明星	M
丁钱精	M
郭小升	M
张巧阁	M
潘建丽	F
刘海龙	M
李桂花	F
王艳兵	M
钱科峰	F
陈恢云	M
厉静玲	F
程志浩	M
吴意波	F
李贤胜	M
周海红	F
黄春娜	F
郑伟科	M
任朝晖	M
唐小波	M
朱代斌	M
叶鲁伟	M
缪忠表	M
崔玉燕	F
陈雅尔	F
夏维均	M
赵永红	M
郑建波	M
王菲菲	F
李燕萍	F
张开君	M
林国庆	M
冷泠	M
刘仁东	M
吴成意	F
石建华	M
陈凡亚	M
许欣	M
万龙章	M
安乐	F
戴幼兰	F
曾日亮	M
罗文玲	F
张方君	M
崔海平	M
林洁	F
章其红	M
秦恩军	M
戴红娜	F
廖克华	M
董良	M
刘桂华	F
宋燕霞	F
蒋红勇	M
闻波	M
李莉	F
翁其德	M
叶亚素	F
陈科艳	F
郑虹霞	F
郑君达	M
张枫华	F
屠良东	M
江海	M
罗云梅	F
陈光辉	M
朱高飞	M
张灿	M
刘彩红	F
年春杰	F
傅红亚	F
许飞云	F
芦碧宏	F
钟伟旗	M
王红霞	F
陈士前	M
李世国	M
张善路	M
王海军	M
沈功平	M
王君浩	M
吴伟益	M
何建香	F
侯亚波	F
陈定巧	F
陈萍芬	F
冯菊兰	F
周平波	F
周旗	F
郑永静	M
佘琴	F
裴昊海	M
沈梅芳	F
何小平	M
王春后	M
崔刘军	M
林岳军	M
肖友清	M
叶建浩	M
徐健军	M
龚和妃	F
张陵珠	F
周春蕾	M
樊佳	F
陈东苗	F
李军娥	F
马婧园	F
周正舟	M
王高亭	M
李灵文	M
周科森	M
王财良	M
李立港	M
娄芳芳	F
魏文兵	M
朱一帆	F
邵柳东	M
张明洪	M
叶行群	M
徐红华	F
陈严	M
丁民果	F
汤梦煜	F
刘智慧	F
孙燕	F
李军亚	M
徐平	F
李祖兴	M
王朝远	M
朱家山	M
俞盈凤	F
陈春芬	F
熊卫华	M
李淑景	F
王燕	F
蒋丽辉	M
黄苏云	F
覃柳英	F
熊术维	F
孙秀英	F
黄贵彪	M
贾毛伟	M
谢清华	F
王明	M
洪丽霞	F
李孝林	M
徐嫣韵	F
王勤	F
李秀琼	F
刘俏枝	F
王攀攀	F
汪小英	F
陈陆波	M
徐策	M
赵富芳	F
张学胶	M
张财亮	M
马苏军	F
余秋敏	F
王萌	F
方思敏	M
张玉玉	F
陈雯芳	F
陈伟	M
吴燕	F
罗文华	M
谢显平	M
常海春	M
任婷	F
严静	F
傅丹寅	F
周飞炯	F
杨咪娜	F
钟静夏	F
李兆锋	M
范春连	F
周剑婴	F
马修勇	M
曹荣清	F
许春梅	F
陈爱华	F
徐意	M
龙文慧	F
莫新英	F
秦连群	M
徐春奇	M
崔琳珂	M
周晓	M
缪平	F
陈晶晶	F
周雪英	F
裘秋月	F
杨坤	M
张露	F
文海霞	F
吴强	M
容金平	M
王爱意	F
徐丽玲	F
缪如意	F
陆玲丽	F
吴彩红	F
洪少可	M
朱立勋	M
贾窥窥	F
李永利	M
樊世云	M
袁宗强	M
胡佳铁	M
高雪芳	F
张世敏	F
刘军辉	F
何挺	M
盛莹莹	F
王春瑛	F
陈钰	F
沈尧娟	F
颜辉先	M
刘娟	F
邓全华	M
童辉	M
杨云	M
王青松	M
杨凯	M
储宣宣	F
胡新星	M
彭诗莹	F
陈秀英	F
兰军	M
毛重容	F
刘文俊	M
刘明敏	M
顾飞君	F
吴海宏	M
李卫国	M
赵旭彬	M
董升平	M
丰叶	F
江雪艳	F
谭斌	M
张晓梅	F
杨小军	M
熊米南	F
谢兰妹	F
黄辉群	M
李春洁	F
张娟儿	F
张旭央	F
蒋芳芳	F
黄凤华	M
刘朝文	M
张俊	F
徐金焕	F
牛芳	F
杨健	M
粟晓娟	F
俞杰青	F
杜恒曹	M
席勇	M
杨春华	M
杨佐文	M
余桂娇	F
邓群英	F
符明亮	M
李茂花	F
杨海峰	M
米杰	M
邓莹	F
朱瑞瑞	F
郁春波	F
何春辉	M
范春兰	F
任强	M
白俊标	M
向卫根	M
赵佑福	M
陈榕	F
陈艳苏	F
毛轰	M
吴先辉	F
张丰	F
雷亮祥	M
王玉珍	F
黄美英	F
袁梅生	M
黄一粟	M
张虎	M
陈济芬	F
刘君燕	F
汪採红	F
涂淑珍	F
郭美珍	F
徐颖颖	F
王冰	M
宋孝君	F
王成	M
陈莉莉	F
郁红琼	F
徐佳玲	F
陈孝茂	M
张小波	M
吴立琴	F
李春英	F
雷云	F
刘同鑫	M
李丽	F
刘忠维	F
李丹丹	F
李朝政	M
范丹萍	F
赵霞	F
舒春晖	F
刘大钻	M
魏伟	M
刘蒙浙	M
闻孝儿	M
蒋万全	M
杨晋方	M
张伟萍	F
武小敬	F
彭加其	M
李宁宁	F
白文聪	F
段兴发	M
刘洋	M
吴黑皮	F
王德勇	M
孙小明	M
李林	M
刘慧珍	F
周生跃	M
童琼	F
彭喜红	F
师许维	F
高春欢	M
郭辉	M
舒尔平	F
张军	F
张庆	F
蒋建萍	F
刘心萍	F
龚永清	M
吴淑梅	F
许伟	M
李承生	M
蒋军杰	M
高容	F
王晓平	M
苏新华	F
季维波	F
周铭	M
俞安粮	M
阮堂明	F
胡代斌	M
程丹亚	F
崔梁	M
鲍芳芳	F
黄蓓蕾	F
鲍可增	F
徐佳丽	F
陈飞燕	F
忻红萍	F
王华	F
吴建良	M
宁武云	M
黄逵	M
郭青燕	F
朱辉	M
高翠梅	F
郑全民	M
李士飞	M
何惟高	M
张桂银	F
杨文鹏	M
徐丽萍	F
魏世磊	F
张瑞芹	F
张玉梅	F
杜永红	F
王新利	F
卢登科	M
纪成	M
王义娟	F
刘玲	F
李坎芳	F
杨乐	M
毛其芳	M
张磊	M
邵乐乐	F
徐永勇	M
王立平	M
张超	M
侯宗萍	F
周忆宣	F
俞妙意	M
赵军刚	M
朱培玲	F
施洪金	M
潘婷	F
陈红梅	F
沈文刚	M
黄永群	M
姜潘正	M
张恩彬	M
郑克均	M
潘晓芬	F
龚泽康	M
刘慧敏	F
金高芳	M
周丽	F
李大成	M
陈建中	M
陈良裕	M
曾勇	M
李洪霞	M
王友良	M
任东栋	M
耿冬梅	F
郭来权	M
朱燕丽	F
陈焕	F
武芳芳	F
苟孟生	M
唐路琼	F
邓艳艳	F
王远秀	F
董赛珠	F
梅占琴	F
姚景景	F
刘强	M
叶拾炎	M
杨红	F
任钟	M
杨慧俊	F
吴雪	F
傅潮琅	F
王从波	M
徐娟	F
杨波	M
柴巍	M
郑巧	F
金红伟	F
张小红	F
张仁华	F
龚毅	M
蔡正虎	M
刘启会	F
张国光	M
王苏意	F
刘佩君	F
郑伟	M
王从枫	M
卿春梅	F
王小芹	F
王彩琴	F
敬菊蓉	F
郑百福	M
严孟军	M
严漂艳	F
吴程峰	M
何存国	M
胡华顺	M
蔡财龙	M
杜崇华	M
陈意波	F
任桂平	M
洪海亚	F
樊亚红	F
桂伟明	M
李佳志	M
金龙周	M
洪娟	F
叶小玲	F
陈海俊	M
张均杰	M
王能兵	M
翁利华	M
曾华平	F
熊燕戎	F
陈磊	M
杨伟林	M
俞银辉	M
李红波	M
王淑琼	F
郑峥	F
叶东	M
吴英球	F
张莉琴	F
洪伦鸿	M
李春英	F
梁梦露	F
刘璀	M
周春霞	F
万荣	F
徐亚平	F
董彩玉	F
廖国伐	M
唐艳姣	F
崔春波	F
叶燕平	F
李春岭	M
陈光	M
刘成龙	M
邹梅芳	F
朱胜贵	M
饶建波	M
杨庆忠	M
易周兵	M
年久红	F
季慧琴	F
张志水	M
向延忠	M
熊枝海	M
吴杰	M
胡丹	F
陈永	M
刘立洲	M
姚思纯	M
吴金飞	F
荆常锋	M
王瑾	F
李碧波	F
戴凤飞	F
郑平	F
余转丽	F
严再法	M
陈瑾	F
任春玲	F
梁卫娟	F
梁琳春	F
严中浩	M
蔡益红	M
王良光	M
陈涛	M
黄乐安	M
王福恩	M
匡志坚	M
王锋	M
林燕	F
陈盈妃	F
朱志雄	M
洪孝芳	M
钟亮	M
徐强	M
金勤琦	M
林适女	F
崔建峰	M
周彩仙	F
竺碧波	F
杨波	F
杨彩英	F
李婉丽	F
施科雷	M
张秀玲	F
严锡江	M
彭承利	M
王建国	M
王能开	M
陈高峰	M
洪存伟	M
周敏君	F
龚亚娟	F
俞虹	F
赵新荣	M
安荣秀	F
邹连明	M
沈亚君	F
钟晓蓉	F
杨书燕	M
邹伟军	M
张贵龙	M
陈君平	M
梁元勇	M
龚巧丽	F
金静芬	F
杨芝荣	F
周晶萍	F
闻武	M
满伦	M
孙培娜	F
洪锡萍	M
姚涛	M
段国英	M
伦学敏	F
朱志芳	F
徐柯柯	F
王艳萍	F
权小娟	F
王科	M
刘散芳	F
解香玉	F
吴存意	F
丰君芬	F
沈成立	M
洪娜	F
周建彪	M
吴海达	M
何锡波	M
李建岳	M
陈海定	M
张宜明	M
徐彦	F
竺培龙	M
丁红兴	M
彭丽蓉	F
陈玲	F
米丽华	F
孔军	F
马珺	F
崔伦军	M
吴行方	M
王国君	M
戴祖国	M
洪惠银	M
褚平局	F
周秀琴	F
郑锡君	M
洪伦大	M
吴远平	F
刘淑贤	F
褚斌斌	F
王俊新	F
郑小芳	F
胡孝珍	F
盛春兰	F
周国莉	F
欧阳小兰	F
陈建行	M
邵乃军	F
洪金意	F
陈海波	F
仇昌圣	M
王和统	M
崔巍	M
冯惠钧	M
徐高岗	M
王红女	F
李启冬	M
张学权	M
王亚群	F
邬玲	F
刘敏	M
刘哲峰	M
吕玲	F
李春梅	F
裴召平	M
陈意芬	F
毛利君	M
叶位江	M
陈孟红	F
应红文	M
洪红玲	F
吴行波	F
刘小娟	F
赵云	F
佟子瑜	F
郭华丽	F
张静	F
楼鹏	M
李文玉	F
陈杰	M
王圆	M
周威广	M
刘轲	M
李燕波	F
李维娜	F
梁海滨	M
王坚静	F
周小芬	F
曹夫国	M
周元芬	F
杨华	M
曹允琴	F
叶亚珍	F
黄玉	M
沈红灯	F
徐红梅	F
周万波	F
缪召飞	F
王婉	F
王春艳	F
涂萍	F
胡玉琴	F
刘爱媛	F
王旭东	M
吴小莉	F
江艳	F
葛瑜斌	M
陈莉娜	F
林陈波	M
林晓燕	F
陈科娜	F
戴光辉	M
徐晓惠	M
黄亚娟	F
毛其波	M
梁华君	M
忻法军	M
黄建波	M
王斌	M
周波	M
赵少林	M
李秀红	F
刘光美	F
李军锋	M
何坚锋	M
龚叶宏	M
苑宗兴	M
陈威峰	M
周海滨	M
杨建明	M
潘立宽	M
王海鹏	M
柴海江	M
陈孟军	M
钟玲玲	F
闻小良	M
闫福才	M
蒙根	M
杨林阳	M
谢丙生	M
黄余富	M
徐磊	M
徐建勇	M
韩杏卫	F
施培凤	F
余意	F
徐丽娟	F
傅国倩	F
周敏	F
侯冀峰	M
赵扣兰	F
范会建	M
吴丽萍	F
周科奇	M
陈慧	F
陈成国	M
张佩红	F
全维波	F
周家强	M
朱柯斌	M
许玲红	F
崔松华	M
陈静达	M
周权	M
袁建华	M
徐永祥	M
陈立云	M
郑荷月	F
周夏芬	F
张周君	M
朱影	F
傅国义	M
李茹	F
王存飞	M
王孟尔	F
崔小立	M
吴州波	M
严婷婷	F
毕志德	M
李董梁	M
宋静萍	F
孙云海	M
姚秋英	F
葛优筝	F
陈曦	M
郑艳	F
邵玲	F
周忠祥	M
文达海	M
赵美银	F
陈秀兰	F
赵晓丽	F
陈卫平	F
陈山芳	M
陈雪兰	F
傅苗方	M
汪华荣	M
黄淑英	F
陈君定	M
汪亚贞	F
俞文婷	F
郑妮	F
谢艳磊	M
李德宝	M
陆雷娜	F
夏静能	M
贺懿	F
朱晓燕	F
夏善金	M
吴锡军	M
徐昌荣	M
熊丽璋	F
田琴	F
杨浩友	M
涂招老	F
汪年红	F
赵少华	M
郑弘杰	M
赵伟	M
王益波	F
张映江	M
刘刚	M
陈红芳	F
徐帅	M
杨玲	F
陶训莲	F
胡慧霞	F
竺静飞	F
赵雅霞	F
刘金晶	F
陈欢欢	F
邓黎明	M
崔伟国	M
陈磊	M
吴利达	M
毛先东	M
姚军	M
董细仙	F
王富兴	M
许娜	F
袁林	M
成小玲	F
任贵平	F
郁敏珍	F
胡海波	F
宁雨娜	F
吴国万	M
黄金花	F
裴光妃	F
贾国友	M
杨梅	F
朱明军	M
王利迪	M
肖跃辉	F
龚世芬	M
李军	M
杨璟丽	F
刘俊琼	F
岳帅	M
李国英	F
王味波	F
胡宇梁	M
黄俊耿	M
陈元乐	M
何昂	M
王跃光	M
田云飞	F
张云园	M
夏建军	M
李翠珍	F
王锡朝	M
周玉梅	F
缪建炳	M
陈茂球	F
唐幼琴	F
陈芹飞	F
崔燕	F
周宜琴	F
吴亚琴	F
杨海平	M
钱建良	M
王德明	M
吴红艳	F
洪锡明	M
姚琼芳	F
黄燕峰	F
吴淼波	M
夏向阳	M
李文斌	M
乐莹	F
周海峰	M
刘晓芬	F
陈孟素	F
薛勤儿	F
严海洋	M
周明浩	M
吴纪达	M
卞立军	M
张孝锡	M
周其苗	M
傅维静	F
施素蓉	F
龚亚珍	F
李春海	M
张志芳	M
吴其君	M
吴启文	F
叶孟军	M
钟贤昌	M
吴立洪	M
贺轩辕	M
尹兴道	M
彭博龙	M
车营	F
黄友文	M
张金军	M
张金菊	F
邬琴琴	F
王俊林	M
周东	M
洪云	F
郑建波	M
杨献军	M
江锡波	F
鲁晏晏	F
鲁冬连	F
郑军萍	F
吴琴娜	F
李祖能	M
王亚军	M
吴纪立	M
崔建杰	M
褚彩娟	F
缪银芬	F
王香	F
隆爱娟	F
马长春	M
冯明娟	F
仲丽梅	F
陈雅芬	F
徐高裕	M
周聪	M
王兴海	M
施苏林	M
郭晶	M
朱承兴	M
李朝钢	M
皮建珍	F
朱伟峰	M
柏红香	F
刘晓飞	M
胡春洁	F
郭雪梅	F
黄根弟	M
应斌	M
章焱	F
周玲	F
吴建国	M
周洪松	M
张乾康	M
王震敏	M
胡美红	F
金小鸽	F
汪文红	M
陈锡飞	F
王亚增	F
陈刚	M
刘亚芳	F
竺继春	F
董锡翠	F
贺幼云	F
叶静维	F
吴玉萍	F
陈瑾	F
陈嘉	F
吴迪怡	F
李兴祖	M
张蕾	F
严方虎	M
薛龙	M
崔爱妹	F
郑勇	M
单祖龙	M
黄川	M
江寅	M
隆华琼	F
田应分	F
冯留锁	M
方明飞	M
黄国英	F
钟长青	M
杨浩	M
李春保	M
张燕	F
徐晓梅	F
袁方妃	F
万秀芬	F
张明甫	M
洪平波	M
卢锡祥	M
李玲玲	F
崔毅丰	M
马涛	M
陈华	M
张洁	M
洪味	F
张亚芬	F
黄渭星	M
吴昌义	M
朱文波	M
张开达	M
唐世兴	M
王裕国	M
陈秋容	M
郭辉	M
吴意红	F
英华水	M
洪元达	M
潘卫球	M
陈明波	M
裴顺锋	M
章联喜	F
陈芳茂	M
郑科达	M
王伟权	M
冯国民	M
洪武军	M
钟亚儿	F
方丹儿	F
戴光耀	M
万春霞	F
李华明	M
杨浩男	M
宋艳丽	F
李永珍	F
陈艳芝	F
羊萍	F
周林爱	F
廖林红	F
赵宝硕	M
李福生	M
徐钻军	M
黄龙飞	M
江维杰	M
朱冬波	M
许云云	F
姚富云	M
郑建梅	F
周少云	M
肖新才	M
杨备军	M
陈涛	M
李飞锋	M
杨仁华	M
谭贵银	M
何存霞	F
沈国宝	M
陈国良	M
钟伦君	M
徐成军	M
潘立斌	M
戴伦平	M
傅元戎	M
黄国成	M
崔高峰	M
孙毛毛	M
罗国飞	F
黄建明	M
周静琴	F
方培芬	F
戴林芬	F
李茂康	M
贾玉红	M
赵均华	M
唐海君	M
忻宁	M
张萍	F
朱建芬	F
张美景	F
陈伟	F
叶锡军	M
徐其波	M
丁凤娇	F
付来贺	M
郑焕林	F
黄燕燕	F
杨华俊	M
孙玉妹	F
刘闯	M
丁二镜	F
查中海	M
郑凯	M
程鹏	M
龙晓玲	F
江海平	M
张玲	F
郭志勇	M
刘培	M
梁鹏	M
王丹丹	F
韩琳琳	F
巫腊梅	F
吴建国	M
张秀芳	F
叶芹芹	F
邓风兰	F
俞小霞	F
周洪江	M
许建玲	F
段艳霞	F
宋盛峰	M
胡七生	M
贺志良	M
李辉	M
金海波	M
郝林叶	F
贺军	M
马召科	M
张殿龙	M
唐啸风	M
刘振民	M
李大勇	M
潘兰	F
陈辉	M
李星	F
陈秋妤	F
江波	M
黄华芬	F
李新胜	M
李贺南	F
杨思琴	F
胡梦乙	F
胡万林	M
梅方	F
李秀英	F
易水芳	F
刘纪良	M
赵辉	M
何艳华	F
侯旭姣	F
郁志明	M
杜凤梅	F
雷礼强	M
段利江	M
姚琼	F
王鲁燕	F
李剑	M
杨雪1	F
吴琼	F
朱兰兰	F
王丹	F
童叶	F
李继元	M
夏卿华	M
宋怀稳	M
陈玉斌	M
刘小群	F
燕治伟	M
周雷	M
裴桂清	F
成淑碧	F
薛玲	F
彭艳	F
罗玉琴	F
孙燕	F
白淑平	F
张鑫	F
吴翠云	F
赵正	M
黄漫漫	F
王二宝	M
许文娟	F
童卫华	M
吴成刚	M
熊叶钢	M
翟军政	M
王月飞	F
顾巧珍	F
郭登华	F
金春龙	M
程雪利	F
熊凌平	F
杨小平	F
陈孟君	M
谢帮文	M
杨腊根	M
黄学权	M
卓燕娜	F
干贤福	M
谭云灵	F
王会娜	F
吴俊文	M
何波伟	M
陈磊	M
李永君	M
陈春芬	F
刘洋平	M
聂佳玉	F
姜金晶	M
张群芳	F
张恩玲	F
王洋	F
郭园	M
徐华	F
凌曼曼	F
王四化	F
戴敏敏	M
叶卫光	M
余美琴	F
撒桥付	M
万义丑	M
郭伟强	M
裘旦娜	F
赵月伟	M
郑炎炯	M
许红仔	F
徐共明	M
程敏	M
兰秀琼	F
黄豪杰	M
林碧静	F
李一顺	M
肖斌	M
王维敏	F
蒙爱格	F
张小红	F
黄丽娜	F
张丹丹	F
牛锋	F
余建军	M
董毓豪	M
孙凯杰	M
唐小兵	M
张友花	F
程锋	M
熊积斌	M
孟令娟	F
曹娟	F
仲宏	M
陈青华	F
汪招凤	F
李年	F
黄喜妧	F
李锋辉	M
周云娟	F
刘庆贺	M
沈科科	M
王林飞	M
曾畅	M
杨少辉	M
刘建林	M
郑骁	M
黄素芬	F
方丽丽	F
候燕	F
姚金	F
赵盈娜	F
刘清	F
谭圣杰	M
张圣峰	M
杨晓东	M
范旭	F
舒平波	M
吴丹丽	F
李小燕	F
顾玉辉	M
伊犁	M
朱平	F
丁兴旺	M
苏长水	M
王应军	M
姜登科	M
方汀	F
唐林	F
徐艳华	F
于燕	F
王锦	F
吴海艳	F
刘莉苹	F
汤秋颖	F
喻淑珍	F
应勇巧	F
郭超	M
向正芳	F
刘成龙	M
汤细刚	M
赖正生	M
周友菊	F
余义强	M
邓丹	F
李春辉	M
吴芳	F
薛培培	M
李传龙	M
龚凤军	M
丁飞飞	F
雷世明	M
孙珍珍	F
胡辉	M
田坤焕	M
刘娅	F
彭亮	M
邵玲	F
黄拿付	M
涂花金	F
李宏光	M
王俞	M
庄敏明	M
孔令兰	F
卫勇	M
吴忠华	M
张亚斌	M
周凌芬	F
李研	F
陈巧巧	F
黄夏冬	F
梅华生	M
朱伟伟	M
牛西庆	M
傅开波	M
吴艳芳	F
李浩	M
李腊	M
李菁	F
刘琼	F
张龙龙	M
陈胜	M
郭峰	M
张涛	M
郑吉存	M
熊中华	M
芦良波	M
傅利萍	F
盛荣城	M
刘诗伟	M
黄铃	F
夏旭栋	M
韦丽虹	F
顾贵宾	M
舒钧	M
刘文玲	F
魏巍	F
谢华华	M
李杰锁	M
魏小华	F
吴华江	M
王林伟	M
顾孝明	M
官远群	F
黄腊庆	M
吴里姣	F
聂秀玉	F
施明明	M
徐广义	M
翁兆娣	F
王露露	F
孙国美	F
谷保银	M
朱学伟	M
苏国旺	M
张震	M
何炼芬	F
古春爱	F
俞珊珊	F
姚佳丽	F
马贝娜	F
王峰	M
王芳	F
蒋丽	F
隋欣	F
马佑民	M
黄炼	M
梁世清	M
王利娜	F
朱红伟	M
吕春红	F
魏玉琴	F
赵津津	F
殷金鹏	M
高国锋	M
邱莉莉	F
徐昌梅	F
傅爱	F
俞立波	M
李功亮	M
孙林会	M
潘金梅	F
朱培义	M
段美兰	F
乔慧娟	F
刘玉连	F
陈美英	F
万智远	M
龚远迪	M
吕斌强	M
聂小斌	M
熊培峰	M
桑佑平	M
王海松	M
罗勇	M
李晓帅	M
邵长青	M
崔宏恩	M
郑梅	F
谈家坤	M
张爱娟	F
吴艳玲	F
陈春生	M
王勇	M
虞根松	M
李绍平	M
邵心雨	F
来盼盼	F
李方海	M
董明聪	M
王正峰	M
孙永刚	M
王小利	F
赵香艳	F
黄剑斌	M
张海伟	M
周三坤	M
王建	M
李杰	M
姚黄静	F
吕美芬	F
周珂琼	F
唐银会	F
韩福晶	M
龙小桂	F
徐翠兰	F
陈经伦	M
杨春梅	F
孙孟荣	F
付善全	M
王艳花	F
朱宝玉	F
刘广霞	F
杨卫东	M
鄢凤玲	F
蔡伟	M
张露丹	F
游小刚	M
李蒙	F
孙东梅	F
孟先兰	F
张天福	M
李小媖	F
甄润超	M
李涛	M
陈香如	F
訾伟伟	M
孙瑞菊	F
黄桂云	F
王成长	M
刘海波	M
王香罗	F
张红霞	F
项慧峰	F
蔡军	M
吴怀良	M
何涛	M
孙怀蓉	F
宋昆	M
刘春梅	F
冯雪波	M
龚划强	M
汤学进	M
顾玉娟	F
马勋	M
袁觅	F
孟海军	M
熊孝芹	F
刘琼英	F
袁国兵	M
王方良	M
游木刚	M
何然然	F
徐茂成	M
李园	M
洪柳	F
胡娜	F
张翠娟	F
陈运珍	F
彭森平	M
柴赛平	F
孟昭俊	M
万至友	M
徐飞龙	M
胡婷	F
胡玲花	F
郭健	M
薛寒光	M
谢丽萍	F
刘荣	F
郭向军	M
林涛	M
肖连根	M
刘宝萍	F
韩英	F
姚胜杰	M
肖永强	M
赵晓春	F
陈勇	M
张秀来	M
林开峰	M
李明	M
彭新根	M
李全胜	M
崔露愉	F
张明军	M
杨洪泉	M
王长妹	F
庄勰燕	F
赵文山	M
高昱中	M
刘笑晨	F
梅明珠	F
贾学娥	F
胡维义	M
戴唯颖	F
郑光辉	M
龚霞	F
黄瑞华	M
郑双娟	F
张波涛	M
万志文	M
余锦玉	M
zhengJACK	M
谢云辉	F
罗小红	F
陈小佼	F
孙峰	M
童元会	F
包晓丽	F
吴美莲	F
陈燕珏	F
乐玲玲	F
邓辉	M
吴耀国	M
陈艳	F
杨丹	F
陈杰	M
宁敏	F
张元表	M
王克珍	F
柯小勤	F
杨杰	M
刘露	M
丁小燕	F
徐泽毫	M
薛敏	F
范亮	M
杜小涛	M
王道安	M
周小勇	M
张美玉	F
郭粟	F
张幼苹	F
漆楚玲	F
奠传雄	M
向荣花	F
王舟	F
饶永红	F
周建平	M
李辉	M
许贵玲	F
黄若愚	M
农秋娜	F
何英	F
戚海燕	F
杨秋艳	F
郑彬斌	M
姜红莲	F
郭超	M
张辽	M
鲍建军	M
张广芝	M
余益珍	F
熊招弟	F
梁会	F
宋惠珠	F
王英	F
韦召芳	F
宋桂杰	F
蒋克	F
刘哲	M
夏小燕	F
周海连	F
吴姚萍	F
武霞	F
李春林	F
杨晓玲	F
汪敏	F
周杰	M
周建平	M
王振	M
翁罕旺	M
高松平	M
李伟	M
罗小琴	F
薛瑞芬	F
舒小波	M
舒建波	M
赵坤	M
侯意云	M
钱婷婷	F
王晓静	F
丁毅	M
刘燕芹	F
王建茂	M
张传好	M
郑萍	F
刁波	M
谢炳伟	M
熊朝梅	F
谢茶英	F
谢彦翠	F
徐琼	F
郑国桥	M
郑桦	F
罗敏	F
戴唯星	F
曾丽	F
杨丽霞	F
严一清	M
张美丽	F
袁红斌	M
白彩	F
帅俊芳	F
赵岳鹏	M
赵春芳	F
周群	F
熊传飞	M
蒲艳	F
胡淑兰	F
胡广贵	M
马惠芳	F
孙良龙	M
李悠武	M
钱冲	M
邓淑云	F
刘晓军	M
纪素芹	F
杨春燕	F
张仕梅	F
徐春省	F
徐百全	M
梁桂峰	M
赵英	F
付春叶	F
鲍海杰	M
赵祥辉	M
王卫民	M
刘宇	M
张青妹	F
雷磊	M
张雪源	M
武峰	M
赵霞	F
夏家喜	M
李昌来	M
周伟东	M
孙荣华	M
毛根莲	F
李猛	M
钱斌	M
罗红梅	F
杨彩霞	F
沈海莺	F
常雷冰	M
刘恒恒	M
钟勇慧	M
田涛	M
杨勇	M
廖晓军	M
刘琳	F
胡萍	F
张惠东	M
牛长影	F
方孝强	M
刘志安	M
吴康	M
苟浩明	M
范铠军	M
李红	F
郭元香	F
郑耀	M
缪良丰	M
张华香	F
孙玉萍	F
言杏华	F
夏阳	M
李礼	F
陈伟刚	M
张秋华	F
方华强	M
陈国柱	M
汪功明	M
李亚平	F
杨星兵	M
程智	M
李均霞	F
王知音	F
徐丽凤	F
江双福	M
操楠	F
李长平	M
田敏	F
章贵	M
胡圣	M
常顺喜	M
李洪伟	M
陈钱	M
罗金香	F
雷代斌	M
任红芹	F
吴洁	F
卢贤迪	M
何敏志	M
张乐	M
洪建	M
胡爱芬	F
缪明杰	M
刘刚强	M
陈荣侠	F
张龙	M
殷凤	F
朱成燕	F
江汉清	M
于同志	M
章金容	F
刘在波	M
赵文芬	F
尹永红	F
樊惠宝	F
孙晓飞	M
李梅	F
王琴	F
禹发惠	F
王宝玉	F
欧小利	F
槐新博	M
汪峰	M
王康	M
顾政	M
郭长虹	M
吴磊	M
王华	F
黄宁	M
李学春	F
李贤圣	M
杨如永	M
崔来良	M
唐少泽	M
吴勤	F
刘爱国	F
何增保	M
杨赞	M
张建华	F
邱志辉	M
方震	M
宣锡军	M
徐莹	F
蔡花	F
王勤勤	F
李振华	M
章晓玲	F
孔令浩	M
卢奇科	M
郭占军	F
舒孝廉	M
舒孝洁	M
张利平	M
万大蓉	F
陈章勇	F
刘东东	M
罗会奇	M
朱正凤	F
徐海英	F
张学群	M
宋刘军	M
单林平	M
杨洪欧	F
肖科	M
刘小平	M
陈冬平	M
周丹	F
毛盛君	M
陈晶晶	F
刘天凤	F
郑耀	M
崔东涛	M
徐照兰	F
吕丽荣	M
段会会	F
史金凤	F
钟美荣	F
余茂闯	M
周青松	M
樊林芳	F
罗杨	F
励洪夫	M
刘云锋	M
缪芳	F
朱斌	M
姚玉童	F
鲁永弟	M
张爱华	F
胡钱波	M
何雨环	M
张威凯	M
赵宽铁	M
叶磊	M
刘蒙蒙	F
刘哲华	M
王慧颖	F
裘桂花	F
程明祥	M
李存生	M
吴晟哲	M
缪层波	F
周佳	F
龚剑	M
方超	M
肖军	M
王慈成	M
谢名鸥	F
蔡勤	M
李瑞林	F
邹永	M
王慧	F
宋仕杰	M
王亚军	M
鲁永南	F
周传雨	M
熊裕普	M
甘银浩	M
周焱苗	M
张航	M
车玲红	F
张涛	M
张宝	F
杨美珍	F
王维冬	M
崔建杰	M
吴科杰	M
黄小华	F
黄任香	F
李小茂	M
陈凌晓	F
赵梅	F
刁菊霞	F
陈勇	M
胡陈宝	M
龚亚明	F
何小谋	M
俞健	F
王建容	F
刘红仁	M
秦海军	M
薛帅	M
张科达	M
汪秀梅	F
黄金凤	F
曹明玉	F
王霞	F
黄丽清	F
牛西宁	M
王梅林	F
周荷敏	F
程玉荣	F
章敏学	M
卞永双	F
孙七妹	F
郑丰达	M
赵刚	M
董云雷	M
谢玉姿	F
刘学松	F
张建川	M
李在友	M
李成成	M
赵文	M
刘仙丹	F
树海平	M
付晓莉	F
王自清	M
周挺	M
吴伟	F
黄小利	M
刘志杰	M
张挺	M
周巍巍	F
张巧利	F
刘艳华	F
谢伟	M
姜涛	M
黄雪琴	F
何旭保	M
孙传宝	M
陈盼盼	M
胡国平	M
许慧红	F
许琴仙	F
杜小鹏	M
张玲	F
王庆平	F
王建坤	M
汪树亮	M
张君芳	F
于绪堂	M
江威	M
虞永昌	M
毕沿沿	F
赖济民	M
陈坤	M
龙永荣	M
龙磊	M
李保臣	M
刘辉	M
张陆岩	M
彭照辉	M
陈敏晖	M
周家平	M
魏建纲	M
邹芳	F
姬刘涛	M
朱水荷	F
林刘芬	F
叶红梅	F
张大衡	M
姜昌平	F
李自谦	M
王春兰	F
郭永林	M
陈韬	M
陈斌	M
万爱	F
郭兰英	F
林其辉	M
崔海芬	F
雷法翔	M
何新艳	M
姚明枝	F
王冬利	M
杜鹏	M
陈佩芬	F
蔡必魁	M
汪玉燕	F
桂莉敏	F
黄小梅	F
王黎明	F
秦秀华	F
罗炎	F
陈华容	F
贾学同	M
张兵	M
祁亭亭	F
刘文芳	F
尹玉红	F
牛晓翠	F
咸兴梅	F
陈强	M
仇小平	F
黄芬美	F
王国伟	M
徐依波	F
归栋	M
刘邦业	M
杨俊	M
潘义珍	F
余亚波	F
孙仲红	F
李星友	M
邓万利	M
祝庆敏	M
罗燕丽	F
王春影	F
吴春红	F
尹长庚	M
郑宇儿	M
林连伟	M
张志涛	M
刘礼云	F
周汉珍	F
李少炯	M
王庆禄	M
程康金	M
万小斌	M
颜其勇	M
徐海波	M
吕苏林	F
张海波	M
方建海	M
钟萍	F
葛红岗	M
梁波	M
朱江华	M
张仁兴	M
吴银徽	M
范德启	M
丁军华	F
叶宗芳	F
杨欠芽	M
刘荣美	F
刘华丽	F
赵端端	F
刘志华	M
朱苏云	F
林玲	F
许青	F
孟爱果	F
张梅	F
孙孔丽	F
周苏梅	F
张伟	M
邓斌	M
李飞	M
程遥	M
李小荣	F
李纯利	M
黄航宇	M
谢小琴	F
冉华瑛	F
张娟辉	F
吴成丽	F
王艳山	M
杨聪	M
陈流丹	F
周凯	M
彭群	F
明廷贵	M
欧静	F
傅培土	M
储菊平	F
王广玉	F
孙腾辉	M
梁嵩峦	M
陶锦	M
陶端佳	M
王志文	M
沈武瑛	F
孙佳瑶	F
王阿娇	F
李洋1	M
于国富	M
罗军	M
李艳鹏	M
黄晶	F
连芬萍	F
刘影	F
孙芹	F
胡良军	M
熊天香	F
张腾飞	M
赵雨婷	F
刘丹	M
王克山	M
肖玲军	M
谌桂兰	F
黄建卫	M
田小飞	M
袁坤盛	M
孙水法	F
张香兰	F
申素云	F
沈明明	F
张龙波	M
籍磊	M
杨志营	M
贡维山	M
李金波	M
赵艳	F
陶鹏	M
杜庆芝	F
邬思惠	M
雷亚洲	M
崔顺安	M
李洋	F
张青	F
史建华	M
潘小伟	M
李路路	M
夏朋辉	M
邓美英	F
唐学文	M
王海燕	F
徐立华	F
鲁素娟	F
罗小文	M
王小娟	F
张锦	F
张敏	F
汪妹	F
杜建军	M
鲁金良	M
杨阳	M
陈启军	M
徐周	M
周秀蒙	F
丁建海	M
曹菊珍	F
黄慧睁	F
奚时东	M
黄璐长	M
杨延浩	M
李友明	M
周秋连	F
刘兵	M
万明强	M
张宇	F
邹晓强	M
赵德龙	M
崔利辉	M
王佳音	F
车立娜	F
曹文录	M
陶社凤	F
胡宝女	F
章进才	M
叶俊玲	F
王盼韦	M
王华荣	M
赵彦玲	F
高燕	F
袁柳环	F
范荣花	F
刘少凯	M
方维安	M
凌冬梅	F
宋学亮	M
白奋军	M
叶文杰	M
何亮	M
张云才	M
熊勇前	M
袁平超	M
刘素琴	F
郑惠聪	M
张海龙	M
王大伟	M
李风芝	F
王志婷	F
施银银	F
张蓓丽	F
闫让礼	M
张二伟	M
李开红	M
何秀军	M
倪圆	M
张珍玉	F
王朋	F
邹荣荣	F
傅增峰	M
廖婷	F
胡雅菁	F
周艳珍	F
李慧	F
兰江华	M
李万飞	M
周冬月	F
张建强	M
吴建辉	M
陈凯	M
赵敖	M
王伟	M
王占友	M
陈珊珊	F
贾宝存	M
周凤英	F
田丽	F
冯伟娟	F
余丽琴	F
王建	M
张振红	F
孙明杰	M
何技超	M
何国财	M
谢艳华	F
王丹	F
勒柏花	F
赵淑娟	F
李建清	M
赵会	F
刘在苹	M
赖娟	F
李俊花	F
梁德万	M
田泽元	M
杨怀珠	F
张朝英	F
杨晓莉	F
卜青山	M
裘宗英	F
梁芳	F
陈立刚	M
仝伟	M
刘彩华	F
华建平	M
马培娟	F
瞿红粉	F
周尚杰	M
梁兴华	M
孙亚伟	M
罗宏勋	M
徐进东	M
陈云	F
李长飞	F
姜石洪	M
聂江湖	M
李建雄	M
高辉	M
胡敬宝	M
刘娜	F
段承林	M
吴珊珊	F
张亚丽	F
万齐宝	M
陈阳	M
袁礼寿	M
吴雷成	M
马壮	M
李桂莲	F
彭泽先	F
胡志燕	F
凌飞鹤	M
张贵高	M
汪克勇	M
张琴	F
方炯	M
谭菊桂	F
詹春荣	M
薛伦波	M
甘家贵	M
叶国军	M
龚禹芳	F
夏龙涛	M
赵贺雷	M
封鹤	F
王俐超	F
潘其娜	F
徐秀君	F
彭志武	M
许敢军	M
杨磊	M
郑国良	M
刘佩佩	F
苑玉忠	M
王昆	F
刘丽花	F
徐雪君	F
霍育兵	M
倪文娟	F
杨杰	F
陶波	M
张陈芬	F
孙学凤	F
周惠秋	F
常立亚	M
周芳升	M
侯静	F
吕德林	M
宣建锋	M
郑欢	F
康冬明	M
于军	M
洪宇霞	F
张桂敏	F
吴阜阳	M
陈敏	F
李华燕	F
胡洪军	M
李永康	M
董海军	F
吴海红	F
杨敬海	M
杨云祥	M
唐桂芳	F
黄伟	M
李亚鹏	M
蔡春维	F
唐丰	F
董万军	M
倪卫忠	M
叶雨琼	F
叶雨梦	F
邓伟	M
张冬冬	M
卞本杉	M
尹凤莲	F
李跃华	M
高祥琼	F
王海香	F
朱晨雪	M
刘娅	F
邵质峰	M
吴芳	F
胡斌齐	M
钟华伟	M
赵高伟	M
徐思梦	F
张建	M
项闽初	M
彭泽望	M
张宝贵	M
杨永秀	F
刘亚文	F
方明勇	M
吴学飞	M
黄定亮	M
杨天宇	M
胡小聪	F
赵丹阳	F
钟凌杰	M
张秀清	F
方建斌	M
胡太东	M
沈敏	M
麻小玉	F
路帅超	M
吴国强	M
任虎杰	M
王燕	F
宁树忠	M
任建刚	M
芦红军	M
廖良超	M
刘博文	M
陶阳	M
党昌隆	M
黄飞	M
邱利	M
方芦远	M
宋冬雪	F
姜国辉	M
唐祥忠	M
钟玉	F
杨薇蓉	F
向平	M
罗洪达	M
陈玲	F
丰昌业	M
吴惠君	F
陈晓燕	F
彭艺	F
王玲波	F
谭林	F
陈秀梅	F
陈小碧	F
赵江英	F
王德玉	M
王茹	F
邵杰	M
张志军	M
孙江	M
韩招兰	F
聂建喜	F
贾方燕	F
彭国清	M
钱龙	M
李毓鑫	M
李灵芝	F
刘文	M
邓俊	M
毛俊淳	M
李敏	F
赵旭东	M
孙宝珍	F
方秀英	F
张静	F
屈阿豹	M
王青云	M
孙佳静	F
周菊	F
张剑	M
罗凌云	M
杨宁花	F
陈科达	M
蔡国林	M
章芳	F
林莉波	F
龚丽丽	F
祁红艳	F
吴秀娟	F
赵建云	F
陈霏霏	F
周美芹	F
王宽	M
鲍唯红	F
吴晖	F
赵英侠	F
汪涛	M
王博	M
彭慧	F
邱秀兰	F
项岳其	M
周林	M
王建军	M
翟家兴	M
刘安名	M
刘树成	M
王红英	F
程其健	M
刘广根	M
许益丰	M
董磊	M
董方方	F
辛波	M
张鹏飞	M
李文立	M
罗华英	F
周玉杰	F
侯倩楠	F
黄海	M
宋润润	F
马苏婷	F
孙永纲	M
缪如光	M
张丽娜	F
徐祖义	M
武少波	M
刘国防	M
荣蓉	F
寇化涛	M
叶丹	F
罗津绮	F
周洪远	F
章颖	F
于军光	M
叶琴	F
彭清芳	F
贾雪琴	F
马永萍	F
陈兰	F
崔海认	M
任桂英	F
金国华	M
陈聪波	F
李录义	F
江洪	M
桑燕	F
赵占花	F
李祥	M
唐卫英	F
曹芹	F
倪海萍	F
徐振建	M
韩超	M
杨虎	M
金章先	M
姚振华	M
俞洋	F
沈杉杉	M
张伦	M
王仲平	M
梁千零	M
张军成	M
詹晨潇	F
梅刚	M
胡善文	M
唐良达	M
刘英杰	M
徐双彪	M
易师伟	M
周琦慧	M
李勇	M
蒋永梅	F
何海军	M
张开虎	M
于佳颖	F
张庆玉	M
程宗星	M
夏院广	M
张宝明	M
陈素红	F
陈炳锋	M
罗芬	F
吴忠宝	M
饶永刚	M
戴文锋	F
职瑛	F
张长利	F
李晓艳	F
刘双建	M
李晓玲	F
潘彩霞	F
魏琳	F
李强2	M
李慧2	F
吴琳	F
沈奎	M
张剑辉	M
赵凯	M
翁世云	F
陈健	M
徐小妹	F
廖芳	F
王慧	F
王辉	M
范楠楠	F
张强理	M
胡泳新	M
张倬华	M
李涛龙	M
昝阳	M
张岳光	M
王春飞	F
贺学强	M
张波	M
叶庆盛	M
左壮壮	M
祝小爱	F
董芳军	M
张玲丽	F
马清风	M
段秀娟	F
徐峰	M
刘浩然	M
涂俊	M
刘小凤	F
薛梅	F
徐飞	M
段康康	M
张敬发	M
朱兰英	F
赵春桃	F
谢意林	M
蒋自力	M
严新朝	M
郑茜	F
赖慧玲	F
赵治中	M
陈晶金	F
李慧	F
黄伟光	M
张新浩	M
吴朋芹	M
卢云前	M
周小兰	F
范信芳	F
陈姗	F
王涣涣	F
张长全	M
王志伟	M
段亚	F
蒙林华	F
何静	F
王玲玲	F
范慧	M
金鑫	M
唐臣刚	M
朱桂珍	F
申美容	F
余晴	F
吴文兰	F
王建非	M
包利琴	F
江秋玲	F
冯焕娥	F
李红风	M
张萌	M
周林香	F
张欣硕	F
张晓艳	F
陈双双	F
王凯风	F
王玉龙	M
张云风	F
肖秋	F
孙海	M
董亚丽	F
胡海峰	M
徐立新	M
张丽	F
董小燕	F
钟盛芳	M
李莉	F
陈小梅	F
魏华盛	M
陈雀兰	F
李军	M
杨晓辉	M
郭凯	M
王红	M
丁鼎明	M
叶迪琴	F
眭欢欢	F
唐利	F
吴念	F
叶秀森	M
杨建清	M
罗宗平	F
胡细兵	M
练峰	M
赵春婷	F
阮新风	M
马利强	M
卢彬彬	M
汪招弟	F
唐益海	M
熊玲花	F
邓琴	F
叶行米	M
张小玲	F
李志诚	M
王丽	F
贺彦青	M
龙大梅	F
薛慧	F
胡宪法	M
姚琪琪	M
王善梅	F
雷琼	F
胡敏	F
张婷	F
顾柏青	M
顾洪飞	M
邢占银	M
仲元亮	M
师广亭	F
赵庆	F
邓之田	M
朱鹏飞	M
王志明	M
刘铁	M
刘红	F
王培芳	F
洪雷	M
候学良	M
胡松伟	M
陈国芳	M
李小静	F
邵锡球	F
刘潘	M
温小蓉	F
昂东琍	F
赵西妍	F
缪龙祥	M
虞惠良	M
屈伟华	M
刘淑光	M
王红梅	F
宋月花	F
牛刚	M
安寸星	F
胡军	M
戴万宏	M
王超	F
王磊	M
许建茂	M
丁体花	F
胡艳	F
黄燕	F
孙进东	M
高俊玲	F
李马寅	M
郭桂林	M
徐非凡	M
余晓萍	F
周康	M
王鹏涛	M
邵卫红	F
许斌	M
邸文梅	F
兰文英	F
漆国菊	F
熊彩霞	F
江文亮	M
杨海松	M
董汉瑞	M
张克冬	F
何俊	F
严增容	F
周林	F
喻元龙	M
杨建树	M
王文	M
许平超	M
孙宝平	F
魏如	M
陈海宾	M
孙秀丽	F
高奇	M
熊泽香	F
周立兵	M
杨永生	M
徐春梅	F
何刚	M
陈瑞军	M
刘想	F
陶渊渊	M
廖利康	M
陈蓓蓓	F
吴尚锋	M
边靖	M
邓小连	F
施力	F
查慧琴	F
郭婷婷	F
张滨源	M
申传平	M
王媛媛	F
林大枫	M
康程雪	F
陈绪平	F
朱国财	M
杜娇娇	F
孟少航	M
贾海琳	F
熊季瑜	F
张颖	F
卢念	F
张玲芳	F
陈祖威	M
胡青华	F
许玲	F
章小慧	F
王武广	M
王秀丽	F
陈霞	F
覃俊	M
江峰	M
金书国	M
张锋	M
吴赛军	F
张海浩	M
黄玉	F
黎兴路	M
金彩云	F
叶鹏	M
万红林	M
李勇峰	M
任立云	F
刘华	M
曾奇	M
沈海洋	M
邱利蓉	F
罗安发	M
朱辉	M
陈家云	F
周菊	F
李文凭	F
蒋丽琴	F
唐春侠	F
吴娜	F
黄勇	M
邱小茜	F
谢龙	M
赵锋瑞	M
郝明	M
郭会宾	M
沈飞凤	F
潘峰	F
袁璐	F
雷招香	F
金莲	F
许大帅	M
熊强	M
郑琪琳	M
沈峰平	M
李东明	F
罗超颖	F
周育勇	M
薛传安	M
薛伏莲	F
张志涛	M
许培培	F
杨燕	F
刘殿梅	F
王磊	M
李佳静	F
韩勇	M
陈江霞	F
张宗令	M
王巍	M
陈国辉	M
徐冉	M
张建华	F
张满琴	F
刘进财	M
陶学华	F
蔡莉萍	F
尹波	F
曹盼	F
代红	F
吴武斌	M
凌德	M
周芬	F
朱原平	M
王文静	F
彭建	M
刘细蓉	F
刘旭辉	M
莫涛涛	M
姚永军	M
肖水凤	F
张芳	F
董锡微	F
柳娜	F
张骞	M
陈兰红	F
帅锡兰	F
常超	M
袁素美	F
余文杰	M
肖开忠	M
李年树	M
张晓东	M
郭艳	F
徐凯	M
章丹丹	F
郭丰安	M
何赛	M
裘林娟	F
孙天标	M
尚吉祥	M
韩凯	M
刘云	F
杨文娟	F
张翠丽	F
袁周丽	F
李存永	M
杜英杰	M
王婵	F
吴亚芹	F
邹家顺	M
赵灵峰	M
曹月红	F
范冬萍	F
张汉	M
于香	F
陈军	M
高力胜	M
周涛	M
张东亮	M
万文文	M
汪法东	M
刘缓缓	F
余红	F
沈红枫	M
周超	M
王磊	M
王兆亮	M
邬科科	M
夏春桂	F
彭波	M
肖磊	M
孙振宇	M
郑宁	M
徐琦琴	F
黄连红	F
卢小爱	M
胡官平	M
朱孟华	M
陈汉淇	M
赵双全	M
李强	M
赵芳	F
汪成	M
汪苹	F
梁志朋	M
蔡贵昌	M
于春辉	F
刘志男	M
汪军建	M
金秋	F
薛晓莉	F
李建华	M
张宇	F
葛莉红	F
叶贤洪	M
胡广仁	M
韩方元	M
马关芬	F
姚正文	M
张倩	F
李纬纬	F
谭冬红	F
吴锡君	M
余红梅	F
熊裕泽	M
薛振兴	M
井浩	M
梅小宁	F
邓红州	M
王志斌	M
颜青海	F
李松	M
熊金刚	M
邬立群	F
徐宏润	M
周相康	M
高玉同	M
任乾峰	M
喻小兰	F
崔光红	M
马楠楠	F
蒋卫红	F
徐广贵	M
樊国友	M
陶建	M
彭国华	M
卞秀芳	F
留慧群	F
向仍开	M
康宁	F
吴宝妫	F
王苏霞	F
郑燕芳	F
洪秀英	F
肖娟	F
彭胜男	F
陈凯龙	M
陈云中	M
丁巍	M
崔杰	M
汪可阮	M
郭建红	M
陈小东	F
李振	M
李莉	F
张平红	F
励董斌	M
周艳丽	F
开义龙	M
陈三扬	M
金明开	M
赵建红	M
张海霞	F
郭红梅	F
赵玉玲	F
王林	M
周爱国	F
夏国花	F
梅珍	F
周晓娇	F
朱方	M
郭馥慧	F
乔治	M
刘敏	F
熊桂英	F
马治翔	M
肖文礼	M
陈云	M
董晓辉	F
胡接辉	M
罗光伟	F
刘彬	M
杜同乐	M
应益益	M
都政轩	M
赵永刚	M
胡善新	M
汪小妹	F
骆盛斌	M
南婷	F
宋新江	M
胡廷社	M
刘小娇	F
孔祥丽	F
刘小清	F
杨玲燕	F
余志伟	M
王祥甲	M
胡国庆	M
吴国胜	M
祝林勇	M
袁宇文	M
刘万收	M
李志龙	M
黄久玲	M
杨辉龙	M
陈志余	M
范丽平	M
康后贤	F
曾展艳	F
蒋洁	F
李琼	F
田兵兵	M
谷建平	M
李凡	F
崔维波	M
黄佳宝	M
黄娟娟	F
邢爱琼	F
张浩然	M
余有财	M
李霖	M
叶智豪	M
汪云强	M
崔碧强	M
乐增艳	F
叶爱玲	F
汤凯娜	F
吴森鹏	M
于新丹	M
左泽明	M
吴美玲	F
谢萌萌	F
徐绵绵	F
张莉	F
张佩蕾	F
顾健华	M
洪金表	M
叶继国	M
杨康	M
张中华	M
刘海兰	F
陈天奇	M
周利金	M
何丽萍	F
李子中	M
华超迪	M
蒋刚	M
李向阳	M
刘小喻	F
金东洪	M
张聪聪	M
江璐	F
王雪丹	F
王艳姣	F
杨奕	F
巫永红	F
张林	F
崔璐	F
朱其君	M
倪超群	F
周映慧	F
王丽娜	F
余红波	M
陆坚波	M
付寒月	F
安军海	M
刘德红	M
李建辉	M
熊鹰	F
杨幸	M
王敬霞	F
李王虎	M
靳朵朵	F
谢维福	M
梁云姣	F
邵璐雅	F
赵栋威	M
申凤乐	F
徐丽	F
赵洪玥	F
曹晓华	M
高凯	M
马章	M
聂磊	M
李亮辉	M
钟文玲	F
马家燃	M
万志强	M
李新华	F
柴春燕	F
胡林锋	M
刘敏	F
谢格	M
陈坤林	M
高会敏	F
张妍欣	F
王兴	M
李配玉	F
张月季	F
茅梦娜	F
史淑霞	F
朱碧珍	F
左国越	M
尹海龙	M
方舟	M
李芳芳	F
王丫头	F
姚红娜	F
闫冬亮	M
赵秀芝	F
魏润泉	M
黄勇	M
王开文	M
蒋育芝	F
姚洪娟	F
汲术菊	F
李贵丰	M
陈迪贵	M
梅坚	M
刘红梅	F
孙海燕	F
雷钊轶	M
冯云	F
徐文江	M
张少明	M
包维歆	F
谢卓颖	F
周婷	F
胡爽	F
李佩蓉	F
林颖艺	F
柯红波	F
徐柱	M
李阳	M
蔡照明	M
陈妍伶	F
张大伟	M
刘俊杰	M
李秋菊	F
付小妹	F
仇怡	F
梁红超	M
赵勇	M
王红梅	F
石雷佳	M
孟庆丰	M
喻德怀	M
钱龙钢	M
盛杰	M
周崇恩	F
周君杰	M
凌云辉	M
戴海红	F
汪莎莎	F
李丹丹	F
张元将	M
方鹏	M
谢斌	M
冯彩麟	M
冯双	F
陈坤	M
周振	M
张显	M
王海啸	M
伍志帅	M
赵宇	M
钟鲜花	F
秦芃	F
高莹莹	F
徐威	M
尹换新	F
王灵钢	M
高海涛	M
崔红娜	F
王田娟	F
钟波	M
汤荣华	M
喻先军	M
陈瑶	F
张华雪	M
原煜玲	F
陈红琴	F
唐继芳	F
吴民录	M
李高顺	M
程振华	M
赖家兰	F
詹涛	M
朱娜丽	F
吴月琴	F
唐芳根	M
谢小静	F
程秀菊	F
赵秀丽	F
韩超南	M
田明涛	M
绳德君	M
李云惠	F
张绍林	F
岑梦梦	F
蒋卓红	F
王城颖	F
沈佳维	F
胡梦娇	F
张美君	F
张宇	M
刘和平	M
洪林	F
计鹏飞	M
金翼	M
崔海朋	M
汪建军	M
李莉丽	F
李海江	M
鲁莎莎	F
张红	F
王学建	M
刘志腾	M
纪陈成	F
杨宇	F
李梦迪	F
石群凯	M
陈琦	M
李宏民	M
张永全	M
万童	M
唐弘	M
李祥元	M
王维旭	M
李美丽	F
付金金	M
何相萍	F
曾友坚	M
蒋力为	M
刘爱军	F
霍志蕾	F
化玲	M
徐春兰	F
高祚敏	M
王晓	F
陈蕊	F
周晓霞	F
白怀东	M
张斌	M
李焕禹	M
郭福元	M
邓祖立	M
石进	M
朱军	M
汪佳红	F
朱佳	M
郭淑艳	F
李伟伟	M
熊艳娟	F
刘游辉	M
孙凤霞	F
安泽林	M
郭子睿	M
胡侃伦	M
邓斌	M
刘琼	F
吴爱兰	F
张小龙	M
朱琴	F
刘博洋	M
查朝姿	F
胡美辉	M
蒋静	F
周磊人	M
袁李华	F
范春华	F
万红英	F
赵小龙	M
白西	M
彭玉虎	M
柳波	F
纪友胜	M
喻虎	M
李欢欢	M
王勃	M
程方慰	M
顾娟	F
袁刚	M
付陆洋	M
蒋小俞	F
徐榆	F
章琴	F
伊文君	M
蒋曦	F
周爱君	F
李龙刚	M
刘志成	M
王伟杰	M
金锁	M
颜亚威	M
夏玉莲	F
阮十花	F
李淑平	F
王天才	M
刘清华	F
贾怀林	M
陈娇娇	F
姚佳	M
曹国梅	F
刘斯坤	M
宋德才	M
李杰	M
朱霖霖	F
熊红妹	F
张震	M
欧苏红	F
凌伟伟	M
林倩	F
陈炜炜	F
俞子郁	F
周志财	M
陈龙	M
谢洪	M
付俊博	M
杨柳	F
韩浩栋	M
朱方方	M
罗文江	M
张雲	F
邵延涛	M
王力恒	M
赵永涛	M
董骁芳	F
王艳梅	F
姚保华	M
杨斌	F
程时荷	M
黄广	M
陈夫大	M
杨建华	M
刘学强	M
朱凯	M
雷宝国	M
汪聪	M
杨圣明	M
张雨	F
李抱	M
甘富情	M
李世艳	F
刘巧梅	F
曹景方	M
李剑平	M
曹志立	M
唐亮	M
谢宝玉	F
鲁官军	M
郭玉桥	M
牛欢欢	F
冯康泉	M
齐辉	M
吴秀琴	F
叶秀珍	F
张延兵	M
黄宁	M
水蛟挺	M
鲁超	M
傅挺儿	F
孙一鸣	M
张建周	M
方宇	M
杨继承	M
俞丹	F
王云禄	M
魏露露	F
张秋玉	F
马辉	M
李超	M
蒋娅	F
任海涛	M
郭文艳	F
陈彬茜	F
吴行江	M
褚凯丽	F
桂涛涛	M
华建英	F
蒋利萍	F
张杰	M
姚琼琼	F
左贝贝	F
王国寅	M
董文凯	M
王俊	M
周采芹	F
贺书锋	M
余兴雷	M
母军	M
刁峰	M
毛超超	F
李良辰	M
王莉	F
邵楚雯	F
孙雪琼	F
曹碧桃	F
黄小连	F
高控球	M
尹桂林	F
陈凤云	F
王序军	M
艾晓梅	F
王海燕	F
朱丽仔	F
葛光胜	M
谢华富	M
童演江	M
范鑫	F
段欠儿	M
刘灿灿	M
吴欣欣	F
李亮	F
黄力	M
尹春雨	M
刘丽敬	F
王永安	M
王雪	F
王燕	F
段亮	M
苏锦娟	F
陈一川	M
侯进醒	M
杨国强	M
蔡世谱	M
张小波	M
段细芽	M
唐水刚	M
肖付国	M
张炼	M
穆镝钦	F
刘燕	F
敖志强	M
黎冬梅	F
王艳霞	F
熊汉星	M
叶芳	F
倪仕平	M
王杨	M
钟杰	M
汪俊伟	M
李强	M
戴恒峰	M
吴文彬	M
祝法芹	F
谢忠富	M
邱胜青	M
毛浩雷	M
孟海潮	M
周训兰	F
夏九英	F
袁叙贵	M
黄青松	M
杜永斌	M
王浩	M
吴将	M
吴军政	M
郑宝雪	F
黄正平	M
秦娟娟	F
周丹	F
伍芳妮	F
方佳怡	F
陈佳玲	F
陈明雷	M
王雪钧	M
金昌策	M
毛海龙	M
江腊银	F
马法土买	F
欧阳雄	M
邵其珍	F
孙剑	M
林丹	F
马腾飞	M
王嘉乐	M
温建	M
韦继伟	F
张爱华	F
赵飞嫣	F
刘淼	F
吕远	M
龚小华	M
王海岗	M
茅雯雯	F
屈孟产	M
兀海燕	F
李伟	F
刘莹	F
余晓	F
邓建荣	M
王菲菲	F
李海利	M
宋百平	M
姜岩	M
席妍	F
曹红艳	F
闵玲	F
张军芳	F
李娜娜	F
龚江	M
郭玩凤	F
刘方文	M
涂美连	F
曹志佳	M
孟伟华	M
朱封唱	M
赵子业	M
熊莺	F
曾润英	F
程禾花	F
许会稳	F
赖胜男	F
李馨桐	F
吴秀茹	F
刁祖兰	F
熊文豹	M
刘茂云	M
崔仕康	M
王瑞芳	F
张健	M
刘绪胜	M
明晋平	M
肖瑶	M
高国军	M
谢辉	M
万女	F
于洪娟	F
戴敏华	M
熊雪萍	F
王桂生	M
唐登富	M
喻承亮	M
陶窑东	M
吴红花	F
陈定国	M
王元亚	M
邓怡波	M
蒲雨容	F
梁素真	F
张改平	M
杨进超	M
马美荣	F
贾永旋	F
易美林	F
马晗	F
王建新	M
麻银珍	F
任建新	M
熊艳玲	F
魏勇	M
朱琳鹏	M
张泽容	F
卢长龙	M
金红叶	F
于艳娥	F
田大超	M
向婧	F
叶友方	M
焦骊嘉	F
李清山	M
袁剑	M
刘贵斌	M
张和勇	M
邹少雨	F
梁秀卿	M
赵国弟	F
蔡文军	M
张小凤	F
朱永霞	F
郭俊敏	F
吴玮悦	M
毛生辉	M
孙兰兰	F
吴庆壮	M
张伟军	F
李菊花	F
施飞	M
杜波	M
谢卓	M
高鹏	M
张秀英	F
崔亮东	M
周杨	M
樊林强	M
苑桂中	M
周家娥	F
朱金坤	M
潘金	F
刘珑斌	M
常向岩	F
张坤	M
蒋代俊	F
于洋洋	F
胡小容	F
车建储	M
陈兴凤	F
杨水连	F
戚定华	M
张玉芳	F
段玉涛	M
黄河	M
王海花	F
任红娟	F
汪亚运	F
唐晓娥	F
顾昊乐	F
丁言伟	M
徐家发	M
魏海英	F
卞荣宝	M
安欢	F
马董平	M
马旭辉	M
胡海霞	F
金旭	F
闻小英	F
王俊领	M
隋文卉	F
滕小英	F
周湘湘	F
罗红	M
孟凡军	M
刘雪萍	F
郭文静	F
陈泳洋	M
孙雷雷	M
张聪聪	F
郑磊	M
万厚坤	M
邱英潭	M
宋立强	M
黄宗娇	F
张志丽	F
王九江	M
卢岳明	M
蔡中雪	F
崔振环	F
廖冬标	M
李勇	M
汪洋	M
蒋燕婷	F
熊花莲	F
陈丽婷	F
吴和金	M
姜如伟	M
吴小毛	M
魏薇	F
张灵敏	F
屈芳珍	F
满明明	M
曹俊华	M
杜同泾	M
付威峰	M
汪晓东	M
张蔚	M
蒋毅	M
吴杰波	M
姚秋艳	F
宋丹	F
李翠	F
魏伟	M
毛平	M
梁大伟	M
余娴	F
李明	M
彭尚巧	F
陈冬	M
鲁琳	F
吴昌云	M
朱丹丹	F
赵娜	F
吴学红	F
邵雄	M
黄家柏	M
邵华	M
刘青生	M
洪志忠	M
王霜	F
陈世洪	M
徐其孟	M
徐絮	F
王斌	M
黄三连	F
缪桂国	M
叶迪芬	F
蒋建芳	F
刘克美	F
周健	M
朱辰丞	M
倪持飞	M
樊俊杰	M
时宗龙	M
马初英	F
莫丽军	F
章惠飞	F
吕宁敏	M
朱敏敏	F
俞朔锋	M
万艳	F
陆瑶佳	F
何雨中	F
朱平飞	M
周献	F
谢士灯	M
郭鸿岩	F
王梅	F
丁祥祥	M
曹红霞	F
张云芝	F
徐兴梅	F
陈立新	M
黄维财	M
黄露	F
厉旭滨	M
袁向荣	F
余昶	M
俞小强	M
李伟兵	M
龚高和	M
万小春	F
张晓燕	F
郝开平	M
黄巧	M
龙梅	F
徐川	M
高丽	F
许芳洁	F
杜博冉	M
东永兵	M
焦思含	F
吕林辉	M
王琳	F
鄢福继	M
许恒磊	M
任彩侠	F
李宁	F
熊永亮	M
郭夏柳	M
徐建强	M
何坚坤	M
江累波	M
高进贺	M
颜国平	M
姜吉宏	M
周春安	M
陈娟	F
万雪琴	F
刘尚枚	M
叶专斌	M
宋玉洁	F
曹正剑	M
于艳荣	F
宋慧媛	F
金萍	F
孟得水	M
陈杭	M
田佳	M
章裕涛	M
林江	M
李丽军	F
黄文爽	F
宋国友	M
钱利林	F
翟玉兵	M
赖辉	M
汪兴栋	M
顾科专	M
王凯	M
吁红秀	F
赵雯雯	F
王开	M
李文嘉	M
冉盼	M
崔雄飞	M
李俊	F
桂灵杰	M
江泉华	M
王皓	M
任丽琼	F
李娜1	F
彭可可	F
胡广银	M
蔡斌	M
邓沙沙	F
杨明	M
夏侨	M
徐佩敏	F
叶萌	F
赵林	M
张天顺	M
岳仙德	M
程丹华	M
林江	M
曾建军	M
李晶晶	F
柯国武	M
夏秋莲	F
李威	M
张涛	M
罗芳	F
王金秀	F
胡大壮	M
董志力	F
缪江慧	F
廉俊彬	M
付浩	M
杜伟	M
吴轶绮	F
顾建祥	M
王灵艳	F
李祥	M
王春雨	M
唐春杰	M
吴永涛	M
邵臻臻	F
郑向桂	M
刘宝军	F
杨蒙	F
白瑞鹏	M
雷亮	M
尹琼	F
朱璐娜	F
颜荧荧	F
应剑峰	M
董湘君	F
唐长桂	M
赵鸿林	M
刘瑞	M
储艳萍	F
张晓斌	M
沈钰波	M
杨振宁	M
李卫民	M
吴锡龙	M
闵勇	M
张浩	M
李洋2	M
欧婷	F
徐建狄	M
陈观水	M
杨光劲	M
李再兴	M
童凯	M
张双土	M
吕玉红	F
范雅洁	F
王彪	M
肖凤	F
喻顺连	F
马万海	M
周之旦	F
包志敏	F
周艳苓	F
姜立平	F
王建	M
翁胜群	M
梁晖	M
邱晨健	M
龚利达	M
马超连	F
陈永祥	M
杨春花	F
刘术	M
蔡汝杰	M
江碧云	F
夏联海	M
王瑞	F
郑灵飞	F
张华中	M
田轶	M
印安美	F
甄更元	M
潘锡琼	M
杨高强	M
喻兴	M
曾星宾	M
徐苑	M
陈旭	M
柳剑	M
陈凯迪	M
陈国良	M
董君荣	F
李雪梅	F
陈文俊	M
陈桂英	F
尹桂华	F
王瑾	F
姜云	F
孙乐林	M
奚久菊	F
王彩云	F
肖平	F
龚玮玮	F
王贤生	M
姚菁	F
顾文林	F
杜火英	F
余彪	M
纪海侠	F
杨新	M
颜小瑞	F
孙玉龙	M
崔玉国	M
李明	M
陈云	M
张玉忠	M
孙洋	M
徐宗耀	M
龙天智	M
谢兴伟	M
黄小波	M
徐莉	F
吴照华	M
肖攀	M
刘冬冬	F
崔卓霞	F
郑维吉	F
顾萍波	F
代如月	F
黄娉	F
姚欢	M
周莉	F
傅莎	F
夏静平	M
谢宗宇	M
郑海波	M
汪小雪	F
蔡君	M
张炉杨	M
崔倩倩	F
郑枫	M
王怡婷	F
万国粱	M
卫新凤	F
徐善军	M
袁平	F
罗才家	M
王丹	M
蒋俊翔	M
许冲	M
吴星	M
马春波	F
刘立红	F
许莹珊	F
胡思旭	F
孙晓斯	F
汪志琴	F
何迎梅	F
李秀	F
王浩潘	M
刘亦文	M
柯用德	M
吴仪	F
程剑锋	M
张建军	M
刘杰	M
余师涛	M
沈燕萍	F
刘旗	M
上丽华	M
董支国	M
刘丽	F
卓森庆	M
陶宇川	M
张运婷	F
张立杰	M
陈浩	M
赵亮	M
颜超艳	F
杨凤霞	F
刘怿宁	M
刘思佳	F
杨倩倩	F
舒春珍	F
郑海素	F
马雯雯	F
江艳如	F
王小梅	F
郭小伶	F
郑海露	F
史丽娜	F
刘彦娟	F
祝山青	M
柯碧莹	F
周琦	M
汪小敬	F
杨水君	F
王建慧	F
朱秀霞	F
徐辉喜	M
赵红霞	F
崔鹏	M
饶明辉	M
吴泽坤	M
王美霞	F
刘增辽	F
赵荣华	M
余新宁	M
张立鹏	M
吕琪	M
王明剑	M
梁鑫鹏	M
李营营	F
王国冻	M
朱飞达	M
范亚飞	M
任国松	M
葛健	M
王小分	F
王艳	F
黄孝正	M
胡勇	M
裘婵君	F
张建辉	M
谢瑶	F
甘儒水	M
何珂妍	F
熊微方	F
段正耀	M
车丽丽	F
吴兰英	F
朱文萍	F
张永宁	M
邵开	M
武艳鹏	M
马珍玲	F
蔡旭明	M
郑小贵	F
黎世全	M
雷青	M
王倩	F
陈航	M
陈桂花	F
沈飞扬	F
孙夏平	F
沈燕	F
周颖姿	F
何雨晴	F
郑珊	F
袁封明	M
张浩	M
汪洋	M
李健	M
刘严泽	M
杨纳	F
高步正	M
张达军	M
王哲正	M
陈露	M
邓帆	M
朱训富	M
周珊	F
吕伟	M
赵杰	M
赵方	M
刘俊玲	F
孙中禹	M
林艳	F
葛琴雯	F
郑圆梦	F
缪颖颖	F
梁革志	M
王继虎	M
陶慧	M
吴凯	M
吴平生	M
熊积智	M
刘江	M
陈瑞菁	F
葛孝栋	M
徐振	M
王程	M
黄建玉	F
唐洁琼	F
李杰	F
姚亦颖	F
管婷婷	F
沈超	M
陈玲	F
杨凌哲	M
易秋菊	F
韩俊海	M
谭先春	F
楼月龙	M
李保玉	M
周晓挺	M
黄玉娟	F
张小兵	M
吴瑶	F
谢冬红	F
陈福伟	M
陈剑萍	F
李汉鹏	M
王腾	M
聂辉	M
崔振涛	M
方娜	F
卢芸芸	F
周燕	F
潘琪	F
胡青青	F
杨晓云	F
杨媛	F
孙妮	F
王立峰	M
汪楚红	F
韩宝怡	F
田学文	M
文健	M
胡晓丽	F
兰家国	M
罗会灿	M
顾娟	F
周婷婷	F
李欣宇	F
张前防	M
夏平平	M
钱德	M
华成杰	M
鲍幼晶	F
嵇冰涟	F
宋旭轶	F
洪程周	M
吕慧婷	F
沈志飞	M
魏正军	M
龚亮莲	F
易忠达	M
缪金弘	M
邱欣欣	F
王磊	F
姚淑英	F
陈实	F
李春奇	M
高金龙	M
陈龙	M
唐瑶	F
周后武	M
盛松发	M
黎雨果	M
陈成浩	M
费蕾	F
曹文静	F
姚燕	F
陈伊雯	F
汤德柳	F
丁国良	M
叶新梅	F
叶龙	M
李绍光	M
林功羽	M
张耀	M
林晓	F
张华明	M
田爽	F
史安波	M
杨继业	M
沈碧兰	F
刘国平	M
汪群美	F
刘欣	M
赵红梅	F
赵子争	M
王海英	F
黄叶	M
尹娟	F
汪美玲	F
李观美	F
戴燕飞	F
屠金丹	F
韩倩倩	F
邵金	F
代月兰	F
贺猛龙	M
尤福旺	M
马宇超	M
宋继辉	M
曾小燕	F
岳强	M
王青泽	M
曹正平	M
卢微	F
晏礼红	F
张宏亮	M
庄新芳	F
何涛	M
娄国标	M
刘进兵	M
周甜	F
杨月萍	F
林萌	F
刘珈榕	F
徐兰芳	F
陈娟	F
高璇	F
王连艇	M
王倩	F
王伟博	M
邹英蓉	F
夏小荣	M
熊长根	M
李玉珍	F
吕清珍	F
谭翠平	F
马妩霞	F
张雅雯	F
林依迪	F
李国华	M
黄旺	M
陈杰	M
沈鹤	M
管华钢	M
刘秋明	M
徐博西	M
张志丹	M
林建强	M
毕鹏飞	M
陈亚青	F
李胜	M
邱桃琳	F
何明杰	M
王瑞凡	F
张前耀	M
朱学义	M
张新荣	F
郭卫斌	M
陈文	M
杨兰兰	F
赵雅	F
黄海霞	F
黄书琳	F
邱诗怡	F
徐文静	F
牟运鑫	F
杨飞龙	M
张俊	M
付建国	M
朱广富	M
张红君	F
赵秀苓	F
马新春	M
李平	F
余莉	F
胡琳	F
刘军	M
朱旻钒	F
陈莹	F
吴静娜	F
楚梦梦	F
孙先山	M
孙凯霞	F
沈菲	F
费丹丹	F
范金美	F
欧阳晶晶	F
胡素	F
周鹏宇	M
陈明	M
江开发	M
陈文博	M
闫伟峰	M
郑蕾	F
凌佳莹	F
王学铭	M
曹建春	M
崔伟明	M
陆奇浩	M
纪道恒	M
钟鹏	M
张东辉	M
谢姣	M
向开花	F
黄贻亮	M
王金龙	M
陈佳伦	M
费吉闰	M
祝笑笑	F
刘彭阳	M
陈洋洋	F
何世良	M
费芳芳	F
况克成	M
冷冰	M
常伟东	M
王建国	M
吴秀娜	F
李侠青	F
李波	M
徐杨泽	M
鄢彩香	F
闫玺	M
姜集正	M
周荷兰	F
肖谞	M
田一波	M
张明鹏	M
李海燕	F
徐讲鸿	M
丁丽	F
杨超	M
余莉	F
朱林林	M
刘明明	M
丁中依	F
龙定稳	M
许金玲	F
王兰英	F
郑晓强	M
曹红霞	F
周方杰	M
钟建萍	F
周候棉	M
陈静	F
汪冬梅	F
李宝龙	M
袁亚宾	M
曹普俊	M
励倩	F
俞增义	M
辜凡	M
魏丽	F
何庆明	M
张贵	M
赵武汉	M
周军	M
董越峰	M
黄露婷	F
肖国平	M
陆雪容	F
唐长林	M
尹福林	M
李鹏飞	M
庄千塔	M
范亚腾	M
姚先号	M
徐少东	M
梁聪颖	F
易祖专	M
刘益鹏	M
罗相华	M
于剑锋	M
王颖	F
何伟光	M
李晓君	M
王洪亮	M
王艳超	M
王晨霞	M
邱立	M
傅国强	M
孟治强	M
张爱萍	F
何涛	M
马关明	M
刘存秀	M
张德义	M
叶青青	M
段振南	F
陈佳予	F
王伟	M
方树杰	M
付伟玲	F
叶晶晶	F
敖文兰	F
李东	M
左玉芹	F
宋梦瑶	F
臧俊翔	M
刘涛	M
林菊影	F
邓必浪	M
高彦亮	M
李雯雯	F
周勰	M
郑树蓉	F
马永会	M
夏春艳	F
夏红珍	F
庞斌	M
郑英春	F
刘聪敏	F
蔡志成	M
侯峰	M
应志龙	M
陈海忠	M
洪增增	F
江桂枝	F
刘鎏	M
牛亚明	M
石小红	F
周贵华	M
雷勇伟	M
张玺	M
赵伟	M
郁宙	M
尹文华	M
李纪伟	M
李凯旋	M
郑奇凯	M
周锋	M
罗佳庆	M
刘好	M
朱丹辉	M
喻茂林	M
闻小希	M
赵海芳	F
刘渊	M
年会祥	M
邓小英	F
朱雪意	F
苏雪强	M
黄玉平	M
穆稳	F
陈运梅	F
李建丰	M
方有军	M
石从坤	M
吴石桃	F
吴文树	M
邓武林	M
陈彩霞	F
李建康	M
孙倩倩	F
杜兰英	F
陈利娟	F
陈国栋	M
侯超粉	F
高君	F
朱智伟	M
冯跃	M
刘振兴	M
王常吉	M
闫俊龙	M
李康平	F
陈明坤	M
刘广宇	M
赵建建	M
赵斌	M
郭连雷	M
卓迪	M
赵静	F
沈盈智	F
周渊涛	M
王军	M
谢亚亚	M
李叶	F
赵虎男	M
周冉冉	F
黄健	M
龚文军	M
魏毅	M
周薇	F
兰海玲	M
张瑾	F
张正国	M
尤金松	M
丁建豪	M
袁佳立	M
王磊	M
杜传彬	M
赵宝平	M
刘立军	M
韩旭	M
李春岭	F
戴银斌	M
张杰夫	M
王登晴	F
马金维	F
孙彤丹	F
张国玲	F
朱涵园	F
爨青松	M
杜欢欢	M
程来迎	M
吴红营	F
曹美丽	F
王朝新	M
秦亚付	M
朱大丽	F
张波	M
汪鑫	M
刘小海	M
程兴龙	M
伯海涛	M
侯琪	M
涂继良	M
谢丹	F
钟晋芬	F
洪亮星	M
张秀丽	F
陈响	F
程丽芳	F
杨兵	M
储俊	M
苏纯东	M
彭松	M
郑新华	M
陈云彩	F
刘萍萍	F
胡海燕	F
唐宗强	M
李小龙	M
汪长华	M
赵欢	F
刘俊杰	M
彭景菊	F
庄海平	M
张衡	M
蔡小军	M
李超	M
吴银儿	F
陈银亚	F
王亮	M
杨振	M
赵春潮	M
吴李兵	M
陈卫	M
赵丽红	F
刘忆	F
刘丽梅	F
王术春	F
杨天云	M
陈令	F
刘飞飞	F
赵孟迪	M
张小英	F
张宝清	M
易昌阳	M
陈仁	M
王旭	M
樊华丽	F
林珍英	F
应芳芳	F
纪莲芸	F
冯成成	F
何梦娇	F
陈富强	M
曾颖	M
李艳	F
张连春	F
刘文亮	M
田琳琳	F
姜振	M
王宁	M
毛佩浩	M
叶余	F
王昊	M
程晋勇	M
龙荷香	F
陈送	M
应苏云	F
涂泽文	M
刘宇	M
王庆光	M
庄仁杯	M
张宇	M
王刻建	M
陆林法	M
饶谟师	M
俞云珍	F
孙峰	M
张坤坤	M
李小斌	M
赵超	M
俞慈峰	M
竺锡春	F
冯宗闹	M
李老虎	M
昌毅	M
郭书杰	M
董金海	M
韩今奇	M
肖芳	F
尹宏昌	M
谢诏	M
田凯	M
曾喜中	F
刘冬冬	M
李欢	M
薛帅	M
鲁春田	M
刘世豪	M
张好科	M
陈国玉	F
李丽歌	F
谈秋玲	F
土比么日且	F
彭召干	M
唐进	M
陈浩	M
曹凤华	F
李程	M
王婷	F
柴崇政	M
姚豪立	M
翁祖华	M
黄晓燕	F
徐晓丽	F
邬启凡	F
余桃娇	F
陈娜娜	F
吕倩	F
郑赐	M
廖可	M
李志勇	M
周婉婉	F
陈虹珠	F
靳传龙	M
陶宝妹	F
孙超	M
吴小玲	F
王旭	M
向群	F
汪梦燃	F
张山	M
朱莹菲	F
曹雨	F
熊晓宾	M
吴博仁	M
惠迪迪	F
赵鑫	M
陈志根	M
李培清	M
杨伟锋	M
邓立军	M
刘君胜	M
范玉杰	M
李改丽	F
彭洁	F
赵玉才	M
刘春兰	F
朱会彬	M
鲍志阳	M
王军	M
李卫华	M
欧林龙	M
徐国强	M
袁宽龙	M
胡振江	M
杨祥军	M
武双	F
程榆淇	F
毛慧	M
陈星玲	F
卢彬靖	M
朱红英	F
王亚	M
范志刚	M
李雪飞	F
杨强	M
张智	M
王素欣	F
金兴全	M
赵满	M
韦钦桓	M
汤圆月	F
肖飞翔	M
周洪	M
王金海	M
俞斌栋	M
江雨薇	F
齐立亭	F
张引	M
张开旗	M
高健	M
陈阿林	M
林波	F
周佳丽	F
应凤凤	F
郑才鹏	M
童财敏	F
王陶陶	F
王凯莉	F
叶晓慧	F
杨帆	F
余森孝	M
王中鑫	M
曹理江	M
胡宇龙	M
朱刘磊	M
王琼	F
单王程	F
张辉	M
候鹏飞	M
卫晓庆	F
王中明	M
艾国全	M
谭双	F
钱丽芳	F
杨盼盼	F
陈赛燕	F
卢央央	F
夏科赟	F
蒋梦秋	F
屈科辉	M
张乐	M
林伟伟	M
褚雪女	F
何勇	M
朱林林	M
王春豪	M
叶家薇	F
严泽群	M
高海岳	M
麻晓莹	F
裴晶瑜	F
杨文芬	F
章婷婷	F
施笑	M
张嘉伟	M
房银波	M
许康	M
徐杰	M
雷伟男	M
姚骏峰	M
朱军	M
杜健	M
薛小春	M
张新明	M
陈丹鸿	F
苗振芳	F
王光红	M
唐媚	F
刘志颖	F
朱晨辉	M
宋杰	M
吴伟超	M
左飞	M
李彬彬	M
沈琪涛	M
王银玲	F
金俊昌	M
杜金奎	M
林宁宁	M
金林英	F
刘二盈	M
李德恒	M
孙敬辉	M
凌象锋	M
柯相明	M
陈树杰	M
周旭	M
何建	M
汪洋	M
熊金平	M
谭翊翔	M
王利萍	F
赵瑜	M
李荣蝉	F
赵添一	F
何冬	M
徐维萍	F
杜小波	M
刘恋	M
沈乾杨	M
张月霞	F
史磊	M
徐悦	F
种伶伶	F
朱广胜	M
汪文宝	M
陈焕锐	M
张文锋	M
雷慧	F
王明	M
陈忠斌	M
赵凯定	M
逄粟	F
张海涛	F
邵艳玲	F
毛茅	M
熊蓉蓉	F
于辉	M
冯召盛	M
王波	M
邹志伟	M
俞易辰	M
朱鑫钰	F
包雨洁	F
王蒙雅	F
冯鑫科	M
胡银娟	F
高姗	F
路蒙蒙	F
杨顺	M
黄荣	M
樊艳军	M
陆静	F
王全	M
陈俊	F
章凤	F
汪成双	F
汪宜彬	M
倪勇	M
黎琪	F
杨正花	F
邓维	M
朱礼晋	M
江灵	F
田玉影	F
甘露	F
冯海	M
焦阳	M
李裕威	M
王远刚	M
赵志红	F
李萌	F
陈明照	M
梁金峰	M
吕江勇	M
傅翠芬	F
李进	M
陈方方	M
孙敏杰	F
杜波	M
温旭旭	M
魏鸿洁	F
王广银	M
李春艳	F
袁世龙	M
吕伟峰	M
涂方莉	F
涂华平	M
范金涛	M
任嫣然	F
满艳林	M
赵莲礼	M
汤豪达	M
夏菊芳	F
陈星宇	M
邓春艳	F
宣昕	F
贺倩	F
李杰	M
王鑫	M
石新妹	F
史建辉	M
李巧芳	F
杨刚荣	M
严曲	M
谌镇全	M
徐先财	M
刘国伟	M
刘朋朋	M
张明卫	M
吁文	M
樊青	F
蔡兰兰	F
范井申	M
武跃建	M
陈亚河	M
海妍	F
李朵妹	F
程松妹	F
陈进	M
陈文敏	F
康国良	M
张猛	M
邵雪松	M
武秀梅	F
张晓娟	F
韩华宇	F
胡振飞	M
陈星	M
管鹏	M
梁巧玲	F
段娟	F
吴家恩	M
徐光军	M
卞冠男	M
王倩倩	F
范凤	F
朱鸿	M
周家豪	M
牛恩召	M
王琦	F
董强	M
章旖旎	F
刘立军	M
祖红梅	F
殷善良	M
叶霞苏	F
张巧迪	F
杨冬科	M
常磊	M
陈伟征	M
胡倩倩2	F
熊玲玲	F
吴雨函	F
沈英	F
胡秀良	M
曾宪刚	M
陈月青	F
李倩	F
陈美丽	F
姚喜成	M
杨建红	F
黄玉翠	F
姚珊珊	F
汤静洁	F
刘辉峤	F
姚彩萍	F
邓云	F
许程	M
王晓军	M
韩震东	M
叶浩宇	M
缪仁可	M
王雪松	M
廖丽莎	F
涂相岗	M
黄琳琳	F
焦彩凌	F
王玮玮	F
李颖颖	F
方雅倩	F
程路辉	M
洪宇齐	M
刘红星	M
王赵盈	M
龚董董	M
刘平平	F
沈其君	M
李书苗	F
万俊	M
支马楠	M
郑思亮	M
赵胤	M
赵春达	M
吕东杰	M
刘亚洲	M
刘浩	M
胡永凑	M
袁孝亮	M
刘雨萱	F
董丹珍	F
吴金星	M
康剑	M
张琦	M
李旭	M
张政	M
韩建芳	F
林舒婷	F
施彩文	F
傅佳	F
于伟	M
王立红	F
关鹏辉	M
王伟	F
丁赵	M
邱银霜	F
严家轩	M
刘军	M
曾武兴	M
刘洪瑶	F
赵光祥	M
王腾飞	M
孙珂	M
李文博	M
曾辉	M
周昶	M
盛伦波	M
刘秀平	M
罗刚	M
徐军平	M
王康	M
郝庆博	M
刘强	M
刘路谣	M
郑柏青	M
张秀波	M
赵李华	M
朱建富	M
刘虎	M
付文才	M
余根	M
段家友	M
黄良友	M
王昊	M
任娜娜	F
梁梦楠	F
王义	M
李小兵	M
时成杰	M
阎艳	F
谢霆伟	M
陶金妹	F
彭杰	M
姚建达	M
程汪意	M
王燕	F
王亮	M
赵沐雨	F
李艳	F
李秀峰	M
宋永洁	F
刘婷婷	F
夏春芬	F
杨雷	M
金刚	M
戴洋艳	F
刘献飞	M
吕锋	M
刘春琪	M
陈小英	F
金龙	M
刘武军	M
邵恩珍	F
徐明哲	M
刘斌	M
徐欢	F
梁兴虎	M
龚丹虹	F
孙玉姣	F
渠俊瑞	F
杨亮生	M
敖国华	M
周勇	M
邱丽娟	F
蒋丹	F
苏晓丽	F
田国双	M
邱世宾	M
毛伟民	M
王前向	M
邹超	M
刘向军	M
诸琳芳	F
张锋	M
邓本红	M
李光	M
姜禄涛	M
谢明君	M
薛胜	M
黄源	F
向苗	F
刘婷婷	F
郑刚	M
江崇伟	M
赵加荣	F
赵丹丹	F
夏龙秀	F
包荷玲	F
黄润仙	F
鲁明号	M
潘仕成	M
陈学稳	M
刘迎超	F
刘平	F
张宝君	F
耿少鹏	M
张林君	M
胡金桃	F
张旭	M
付强	M
熊克刚	M
张雪	F
符莉	F
冯先梅	F
马勋雄	M
王成	M
刘圣	M
谢标	M
许董圆	M
金杰	F
王万军	M
李才	M
李书敏	F
岳莹	F
张蕾	F
易石义	M
刘会录	M
何建民	M
洪程茜	F
董得胜	M
张楷乾	M
凡小林	F
杨德富	M
张后荣	M
毛清云	F
徐建文	F
晋玉浪	M
肖伟	M
宣纪祥	M
孙勇	M
刘强	M
顾美华	F
吴新艳	F
左荣清	F
左荣洁	F
刘香	F
曹其帅	M
孙千兵	F
杨垂光	M
袁荣华	F
吴国英	F
赵彦东	M
杨运	M
庄玲玲	F
黄珣	M
陈琳娜	F
苏丽娟	F
梁蓓蓓	F
常全	M
吴凯	M
康召志	M
宋耀锋	M
吕吉祥	M
章玉琴	F
薛秀夫	M
郭函奇	M
朱成群	F
丁婷婷	F
李锦程	M
马强	M
艾小顺	M
李辉	M
陆凯峰	M
袁福云	M
马波	F
陈秋霖	F
陈肖鸣	M
雷东	M
郑婷定	F
胡斌	M
于芮	F
仵晓晨	M
石钰斐	M
顾小峰	M
卢玲红	F
王伟	M
马骋	M
胡少雨	F
郭新志	M
陈静钱	M
董莉潇	M
王亚辉	M
陈瑶	F
蔡立敏	M
张磊	M
谢萍	F
欧阳世超	M
熊文杰	M
郑胜红	F
卞丽	F
李国维	M
陈志宏	M
左荣翠	F
夏淑萍	F
张冬旭	F
黄超群	M
马金龙	M
徐浩	M
张明娟	F
周卫化	M
李丽	F
吴梦君	F
金苏婷	F
玄泽凤	F
何俊	M
杨世余	M
朱圣强	M
蒲松	M
岑琪	M
林铖	M
蔡彦林	M
黄益斐	F
杨丹	F
王兴甫	M
杨娥利	F
惠松	M
李杨惠	M
徐红彬	M
徐文磊	M
涂方兰	F
刘敏	M
李超	M
唐伶芳	F
王亚旭	F
宋奇	M
余霄	M
刘强	M
余秀云	F
蒋川阳	M
刘贵红	F
何雪	F
张春艳	F
覃桂芳	F
周静	F
姜丽	F
程保珍	F
刘雪梨	F
代东洪	M
吕乐棣	M
周庆伟	M
陈增祺	M
陈蒙	M
李莎	F
童娟	F
刘永佳	M
李佳	M
梁洋洋	M
段志波	M
张文贺	M
马阿一社	F
申志卿	M
杨扬	M
王卡	F
宋树全	M
余芳芳	F
陈仕麟	M
周丹	F
朱佳达	M
于亚慧	F
贾玲涛	M
白友珍	M
粱利梅	F
杨玉萍	F
岳丹平	F
张苏瑞	F
苗东升	M
赵秋	F
范银芳	F
段增云	F
郑会平	F
于宝东	M
倪佳丹	F
张文文	F
万娟	F
刘文佩	M
朱银燕	F
蒋庆伟	M
钟英	F
王黑英	F
叶君健	M
吴秀珍	F
佘玲玲	F
叶先锋	M
王悦	F
冯建宁	M
郑烁焰	F
查剑文	M
刘君	M
孙学	M
杜承刚	M
邹卫东	M
王红帅	M
蒋成	M
吴立彬	M
刘冬	M
陈莹莹	F
陈兴德	M
柳华宗	M
丁红磊	M
穆二领	F
吕田华	M
谢洪侠	F
杨加虎	M
阚世忠	M
董红宇	F
雷强	M
庞思恩	M
傅永仁	M
蔡理建	M
王传丽	F
甘清	M
杨腾	M
江辉	M
武孟姣	F
毕章旭	M
陈标	M
李珊珊	F
霍东凤	F
陶志勇	M
赵世杰	M
李杰	M
李斌	M
林卫兰	F
单智勇	M
王宁	M
李郑	M
刘嘉	M
黄苑斌	M
钟晶	M
孙振业	M
董正颖	M
龚兴	M
鲍洪年	M
王力	M
陈欢	M
蒋吉芳	F
余糖明	M
莫小亮	M
李佳杨	M
杨菊兰	F
余淑英	F
陈美薇	F
王若冰	F
李金伟	M
李爽	M
赵海波	F
王波	M
邱木华	M
梁彩登	M
缪智永	M
谷章杏	M
汪乐琴	F
骆有春	M
吴园园	F
敖瑞祥	M
王杰	F
吴亚妹	F
桑瑞祥	M
郭玉玲	F
高应华	M
谭元财	M
李博文	M
李皓文	M
忻雍康	M
王建设	M
陶江	M
刘露	M
陆恒	M
李美玲	F
胡莹洁	F
鄢惠	F
车文杰	M
唐秋念	F
陈远国	M
周福杰	M
刘顺	M
李士民	M
胡立志	M
李超	M
包进普	M
余正明	M
杨俊贝	F
黄光焕	M
吕翠茹	F
叶翠	F
冯伟涛	M
李全香	F
叶惠君	F
王杰	M
闵忠玲	F
昌天平	M
毛圣进	M
武师	M
李鸿斌	M
邵伟利	M
左希	F
何菊梅	F
徐方圆	F
王琪	F
俞丁旗	M
林凯达	M
盛曾亮	M
李国柱	M
孙有茹	F
黄卓然	M
陈余	F
夏青青	F
刘春桃	F
许美艳	M
陈雪玲	F
冉雪丹	F
王莉	F
白建强	M
董涨潮	M
李功强	M
刘玉玲	F
梁李娟	F
严海标	M
彭开鸿	M
楼洁玲	F
袁仁何	M
祝盈盈	F
周婷婷	F
张菁	F
张玉梅	F
李成明	M
陈民龙	M
杨明	M
黄建宇	M
蒋宗财	M
王建栋	M
安玉业	M
赵勋	M
陈佳莹	F
王银儿	F
孙玉波	M
牛惠敏	F
罗通	M
杨玉东	M
程丽丽	F
胡小英	F
吴强	M
薛可可	M
孟宪晨	M
任玮玮	F
裘佩佩	F
吴翠华	F
宋英杰	M
韩旭	F
文千永	M
段红叶	F
程乐乐	F
卢成军	M
廖建兵	M
师美眉	F
戴文贵	M
朱传舜	M
郑婷尹	F
万九龙	M
王登凤	F
黄涛	M
闻霞明	F
王春玲	F
程立可	M
唐七梅	F
祁琴	F
刘清清	F
骆善勇	M
唐健	M
李芳	F
吕付各	F
李作凤	F
陈奇云	M
米色莫阿牛	F
赵丹丹	F
俞晶	F
李微微	F
伍永成	M
薛利民	F
王燕	F
韦志远	M
张义	M
陈星帆	M
杨慧	F
徐小龙	M
洪咏芳	F
章珊珊	F
董泽勇	M
徐永德	M
华翘	M
陈对	M
戴弘	M
陈露露	F
蒋春梅	F
张杰	M
秦丽娟	F
吴寅	M
高东威	M
王妙萍	F
张利强	M
蔡冬秀	F
刘芳	F
王红玉	F
陈大河	M
陈世升	M
蔡定珠	M
李会芬	F
胡祖伟	M
徐其旺	M
陈桂菊	F
王胜艳	F
丁丽萍	F
应霞	F
缪灯红	F
李哲	M
湛越	F
王斌	M
李检	M
汤立新	M
聂君	M
蔡青	F
叶连军	M
赵彦晴	F
云红森	M
刘林	M
孙昊	M
胡岸群	M
姜瑞跃	F
曹和理	M
许翔	M
王雷	M
罗冬	M
郭子琰	M
刘晒晒	F
程怡民	M
熊桂生	M
赵峰	M
李平沂	F
刘宇	M
胡良虎	M
刘玲	F
孙现军	M
赵福春	M
杨威	M
孙微	F
王秋云	F
苟鑫	M
舒宏辉	M
宁冰心	F
张润玺	M
徐声赞	M
罗路路	M
陈黎新	M
潘利波	M
马小燕	F
马君	M
马少武	M
石磊	M
米玉贵	M
袁文萍	M
杨纪芬	F
孔祥俊	M
亢东鹏	M
马碧波	F
吴勇和	M
陶连花	F
陈其超	M
段思文	M
黄绍敏	M
陈洪平	F
胡金师	M
金东	M
刘同飞	M
颜佳丽	F
陈方方	F
葛开明	M
贺秉涛	M
宋雪松	M
刘青	F
周杰	M
吴堇露	F
程佳明	M
卢菊琴	F
薄振红	M
梁新民	M
石豪杰	M
李小刚	M
陈炬东	M
芶四英	F
周晓宇	M
吕渊博	M
王久辉	M
张书鹏	M
鲍玉霞	F
董丽娟	F
梁月	F
丁莉莎	F
陈玉娇	F
李伟斌	M
王子刚	M
赵明星	M
谢畅	M
刘彬彬	M
曾勇斌	M
马晶晶	F
史学海	M
张芳霞	F
徐洁	F
李佳杰	F
贾启帆	M
林旭益	M
邵郑怡	F
王易	F
宋连云	F
曾坚	M
李丹	F
俞碧勇	M
许则聘	M
魏军	M
邓国萍	M
杨琴琴	F
贺志刚	M
唐志为	M
刘东明	M
王玉立	M
谌云	M
徐喜林	M
邬家欢	M
张该	M
胡振名	M
虞佳	F
祝媛媛	F
姚巧女	F
徐荣明	M
张慧	F
吴石龙	M
覃昌龙	M
李勇	M
曹忠波	M
周双青	F
余匆匆	M
周武	M
陈世勇	M
袁兴磊	M
许丽娜	F
吴金平	M
赵发平	M
妥斌	M
陈洋洋	M
王宏	M
刘冬冬	M
顾郑平	F
马明福	M
董相均	M
唐广	M
吕培金	M
刘琼	F
许翠荣	F
赵农章	M
潘亚男	F
许铁平	M
李发顺	M
陈灵萍	F
刘芸	F
罗吉会	M
段田	M
曹茂丰	M
陈佳	F
高承光	M
张美华	F
许奇芳	F
鲁飞虎	M
魏晓清	F
贾立杨	M
吕鑫	M
刘秀敏	F
王开秀	F
熊乐芳	F
李乃春	M
刘中欣	M
刘畅	M
熊海军	M
孙倩倩	F
叶燕妮	F
柯成	M
余春林	M
欧林	F
胡蔚	F
熊胜军	M
龚世麒	M
王笑	F
刘敏	F
杨龙龙	M
张世万	M
王凯	M
郭道梅	F
杨红运	M
黄渤	M
肖玲燕	F
万小娥	F
伍雨颖	F
李国成	M
张开东	M
陈枫	F
刘杰	M
程海鸥	F
程丽儒	M
饶雪平	M
仝成玉	F
朱晓明	F
赵帅帅	M
陈浩	M
伍思宇	F
任宁	F
孙恬恬	F
王吉崇	M
王依宁	F
郭燕飞	F
张雨	M
赵彬潇	M
程新菊	F
陶学堂	M
邹秋连	F
田芬	F
杨慧敏	F
龙娴	F
豆宁宁	F
刘海波	F
廉羊群	M
贺小玲	F
王生才	M
张德水	M
杨恒	F
王占东	M
张吉豪	M
李步良	M
汪发	M
张钦	M
牟德康	M
罗群迪	F
王秀清	F
王海超	M
陈欧鸿	M
宿萍萍	F
周士友	M
刘明强	M
孔向英	F
张正娥	F
张兆丰	M
易桂英	F
蔡财根	M
程小武	M
陈侠	M
陈小林	M
肖骏	M
尹志红	F
郭怡雯	F
吕洪	F
来新乐	M
章文进	M
张超	M
尤在彬	M
史娴	F
李立	M
刘文玉	F
张势昂	M
梁旭明	M
闵明明	F
陈伟忠	M
马洪	M
汤志菊	F
王水芬	F
高翔	M
朱勇企	M
蒋大伟	M
朱小玲	F
马化美	F
李春涛	M
秋云龙	M
许丽	F
冯玉杰	F
黄长春	M
王超	M
程雪	F
丁术旺	M
吴政委	M
邓福华	M
梅建平	M
熊晶	F
荆冰心	F
王亮	F
吴君君	M
吴有乾	M
郭玉生	M
王小梅	F
李恩琴	F
罗崇涛	M
李少东	M
孔维聪	F
刘克军	M
高增	M
徐国文	M
皮冬如	M
孙汝坤	M
李斌琦	M
姜喜禄	M
马国峰	M
鲁星星	M
刘忠玉	F
浦桂香	F
张丽君	F
张兴广	M
蔡军	M
楼晨	M
张智	M
沈美	F
刘德琴	F
崔乾蕾	M
杨志广	M
胡蓉	F
李义文	M
祝锋	M
陈丹丹	F
喻巍	M
叶小燕	F
包学青	F
张松妹	F
戴亚珍	M
周丽红	F
万致平	M
赵硕峰	M
卢庆	F
张冀	M
徐意婷	F
程长平	M
林金芳	F
王昭	M
俞江	M
许振	M
曾明久	M
吴晓东	M
沈丽娟	F
徐玉明	M
林馨星	F
韩岳丹	M
王逸峰	M
林照	M
万琪	M
徐小华	M
熊小燕	F
侯玉双	F
张后后	M
马佣	M
杨斌	M
李雯君	F
金晶	F
武灵灵	F
胡雪辉	M
邬伟东	M
刘先英	F
张磊	M
蔡晓鑫	F
孟亘	M
徐菁菁	F
方超晨	F
丁锦颖	F
罗雅尹	F
沈曼莉	F
胡佳伟	M
窦亮亮	M
黄伟晨	M
孙源	M
方川	M
尤静霞	F
马小婴	F
于爽	F
袁晴怡	F
潘卫兵	M
任宽雨	M
郝帅	F
邹惠娟	F
康正敏	F
郝海波	M
杨贤孝	M
熊东东	M
高攀	M
陶园园	F
周锦男	F
王秀秀	F
王香	F
林朝滢	F
易小燕	F
沈林惠	F
郭风玉	M
徐慧飞	F
张亚静	F
汤红珊	F
沐利杰	M
王磊	M
熊红霞	F
丁遵雷	M
何微微	F
孟庆鑫	M
纪雷	M
胡刘杰	M
王太平	M
赵玲	F
沈能洲	M
王敏	M
姚本文	M
陈华东	F
任春	M
乔晓龙	M
王钰	M
储旭东	M
槐坤	M
吴孔敏	F
卢卓	M
王春红	F
贾斌	M
叶华淑	F
吴立斌	M
龚庆祥	M
董永斌	M
杨桂香	F
涂美兰	F
毛旭华	M
何朝辉	M
陈嘉	F
王芬婷	F
陈飞	M
王大伟	M
付淑霞	F
徐艳	F
潘增君	F
徐晓兰	F
黄静媛	F
张鹏	M
林维芳	F
陈斌	M
白逸	M
刘志妙	M
卢其林	M
喻文俊	M
陶婷婷	F
谭帅	M
刘鹏飞	M
李玲	F
虞思远	M
肖飞	M
张学芬	F
袁科杰	M
栢泽元	M
祝姚威	M
刘慧玲	F
吴莉芬	F
徐珊	F
王宁福	M
朗杰偏初	M
傅利	F
林诗涵	M
韦贵龙	M
奚广东	M
葛海长	M
牛运然	F
忻惠波	F
齐国芳	M
贾营营	F
周碧芳	F
左慧	F
周东徽	M
魏春蛟	M
李优娣	F
王青青	M
江滇桂	M
黄梦祥	M
刘奇平	M
吴丽花	F
杨百顺	M
张俊	M
王昌敏	F
桑榆	F
尚鹏飞	M
钱邱波	F
游云良	M
刘利权	M
谭林	M
丁铃	F
朱启鸣	M
龚斌	M
谢杰	M
秦斌	M
刘杰	F
杨樱	F
杨锦梅	F
黄克琳	F
赵开杰	F
栾红霞	F
朱敏波	M
严凯春	M
余小丰	M
章金标	M
张剑	M
顾媛媛	F
朱娟	F
罗霜平	M
凡丽琼	F
马炳贤	F
范武平	M
万茶红	F
杨智杰	M
白玲玲	F
阮婷婷	F
任聪雅	F
毛琦龙	M
黄旭平	M
李猛	M
张旭	M
苏湘华	F
李益鹏	M
唐朝玉	M
陶升	M
李锦	F
刘文涛	M
丁时林	M
蒋振兴	M
张艳	F
张振强	M
陈洪燕	F
郭丽英	F
蓝开斌	M
王小琼	F
康宇	M
张俊青	F
冯静	F
赵文明	F
张光强	M
魏振华	M
徐仕奇	M
石冬生	M
韩华	F
张仃仃	F
黄克友	M
邱平平	M
吴玉株	F
王振群	M
欧阳波	M
佘志峰	M
胡启会	M
蒋科	M
晏华林	M
杜飞	M
刘合心	M
牛庆团	M
李变枝	F
张恒	M
张俊峰	M
黄演均	M
吴方欣	M
杨宏伟	M
张春梅	F
王河元	M
郑思用	M
王长刚	M
王萍	F
卢棋	M
赵海峰	M
赵学浩	M
褚平苹	F
宋君	M
连文艳	F
冯美花	F
龙闪闪	M
黄敏	M
高辉	F
姚敏	F
王建军	M
黄宁	M
张英杰	M
杨佳萍	F
宋子俊	F
涂燕	F
孙家乐	M
侯梓阳	M
屠寅菲	F
邹鹏艳	F
钮萍	F
朱旻	M
荆效祥	M
余星星	M
刘东	M
李双玲	F
巫伟军	M
宋倩	F
高继旭	M
杨生青	M
马爱花	F
张震	M
陶宏伟	M
叶丹	F
居立见	M
蓝海伟	M
祝贺菊	F
苑蕾	F
孙思伟	F
李强	M
吴林肯	M
张挺	M
杨艳	F
李瑞华	M
王洁	F
农敦	M
程伟	F
权赛	M
李光辉	M
朱学得	M
赵连忠	M
夏念	M
吴应军	M
杨丙坤	M
夏月兵	M
汤海燕	F
刘宇坤	M
孙徐立	M
闻杰	M
车安宁	M
许晓义	F
章思雨	F
蔡世鹏	M
李贺	M
孙欣	M
熊雪琴	F
张瑞峰	M
熊蓉奎	M
王雄	M
石岩岩	F
徐世萍	F
刘君	M
娄坤	M
王皖晋	M
潘海艳	F
何东强	M
屈全	M
包润	M
胡佳超	F
赵金平	M
肖立栋	M
黄平	M
王晓	F
潘燕芬	F
陶桂连	F
韩玖华	M
马勋考	M
李安东	M
李亚丽	F
董雪梅	F
赵军柱	M
张陆陆	M
赵凤	F
朱冰	F
刘水秀	F
徐秀枝	F
王其平	M
王常勤	F
周灿军	M
陈亚露	F
谭成孝	M
董登雲	M
马利	F
胡浩然	M
郭文振	M
刘超	M
白涛	F
樊利昌	M
熊亭亭	F
马全寿	M
邓莉贤	F
冷得菊	F
夏梦玲	F
肖坤	M
李亚平	F
崔闻文	M
赵文钰	F
杨菊华	F
竺莉	F
周贾媛	F
王婉君	F
李娜2	F
陶佳颖	F
曾梁军	M
林至霓	F
徐放放	F
李扬	F
李飞	F
朱启英	M
范叶宏	M
李恒梯	M
李海超	M
危朝阳	M
金绍芬	F
陈一帆	F
崔仲侨	M
王涛	M
朱应成	M
杨明锋	M
赵志诚	M
左诗奇	F
张敏俊	F
全满霸	M
张永旺	M
胡亭亭	M
许国强	M
宋泸齐	M
胡才志	M
丁晓杰	M
魏冰冰	F
赵振华	M
潘建英	F
张斯蒙	F
王顺帆	M
李雪峰	M
张彦雪	F
万涛	M
高艳霞	F
李阔	M
季忆晨	F
张永丽	F
周天鸿	M
陶家勇	M
王建超	M
翟云建	M
路鑫磊	M
张信权	M
吴超	M
孙雷	M
魏婷	F
李梦涛	M
单晓晨	F
刘乃静	F
蒯家斌	M
王友苗	F
冯桂芳	F
何文治	M
姚秀娟	F
贺咏华	M
王立雷	M
蔡红菊	F
李腊凤	F
来俪俪	F
白光应	M
杨龙	M
路思宇	M
邓东	F
陈亮	M
黄丽丽	F
谢子尚	M
王妙凡	F
石静芳	F
李国英	F
熊成龙	M
崔文英	F
杨志强	M
游剑波	M
余旗	F
李春堂	M
卢文康	M
倪和平	M
任济	M
陈丹幼	F
张旺玲	F
朱妙燕	F
周梅妃	F
钟松娣	F
张祖光	M
吴小娟	F
蔡直敏	M
陈露	F
袁华平	M
郭社广	M
冯林泉	M
于世威	M
宋会珠	F
邓晓爱	F
孙志刚	M
凌飞武	M
黄子健	M
谭松青	M
万刚刚	M
白冰	M
张爱利	F
张钱霞	F
潘荧颖	F
陈玲玲	F
罗敏	F
王小琴	F
汪慈	F
陶冶操	M
方砚	F
余华平	F
赵大军	M
潘仪萍	F
沈建芳	F
陈祥辉	M
陶月玉	M
宋双	F
唐小华	M
杨晓芬	F
桂红民	F
刘长宝	M
蒋修成	M
陈大余	M
余美华	M
王杏平	F
万议国	M
徐美霞	F
陈家林	M
董艳艳	F
夏璐	F
王芮	F
李芳芳	F
粟宁红	F
施宇轩	F
张响	M
李红建	M
刘奇奇	F
曹传红	M
何丽君	F
刘怡萍	F
周敏	F
蔡夏军君	F
王淞煜	M
刘泽亮	M
莫晓菲	M
冯帅	F
腾洪威	F
汪海瑞	M
付善昌	M
陈结成	M
张家兴	M
马江龙	M
任文亮	M
李泽硕	M
陈广琴	F
刘光祖	M
金罗英	F
何海红	F
刘树威	M
吴汉宇	M
王彦	M
刘丹	F
宋枝娜	F
李南	F
徐琦	F
肖至鹏	M
徐飞飞	M
张盼	F
李斌	M
程建军	M
郭益升	M
于斌奎	M
王瑞杰	M
杨弯弯	F
陆威旺	M
王庆红	F
彭冬飞	M
申仪涛	M
耿风	F
张瑞成	M
由利剑	F
陈伟	M
李雁君	F
尚春林	M
储昭节	M
李梦萌	F
陈欣梅	F
任滨	M
王永宁	M
张良权	M
吴优优	F
陈自力	M
周逸云	F
冯迎春	F
陈星	M
董温平	F
魏春燕	F
李宏超	M
王玲玲	F
肖刘阳	M
王书环	F
黄明琼	F
徐鹏辉	M
梁大翼	M
罗花兰	F
黄追	M
彭敏敏	F
马兴跳	M
梁燕莉	F
王云飞	M
韩逸锋	M
陈坤朋	M
邵松梅	F
冯赛	M
刘德伦	M
刘玉	F
石小苹	M
邢明臣	M
唐卫	M
钟雪央	F
张毅	M
江雅云	F
魏丽娇	F
闫玉珍	F
李琴	F
占勇	M
王爽	F
陈琨	M
高文博	M
何鹏鸿	M
章红	F
王庆	M
徐五华	M
曹慧丽	F
杨宁	M
唐强坤	M
耿德国	M
陶钰	F
汪淑霞	F
唐倩倩	F
黄学晨	F
刘利倩	F
张晓海	M
余建	M
陆桂连	F
王路宁	F
王振美	F
韩翠莉	F
厍华成	M
陈令坤	M
刘明娟	F
叶军伟	M
范鹤丽	F
陈文文	F
李辉	M
王静雨	F
马金梅	F
黄凯	M
何小婷	F
汪荣	F
吴小玲	F
王军	M
马凯	M
徐燕燕	F
陈英大	M
李世伟	M
兰艳	F
闵尊涛	M
徐淑云	F
曹广欢	M
姜豹彝	M
黄波	M
孟庆涛	M
郑科威	M
杨祺	M
李德立	M
缪志旺	M
滕晓燕	F
侯梦良	M
陈虎	M
周弘	M
鲍科宇	F
袁文娜	F
毕烁	M
李志成	M
王春英	F
熊祥云	M
李瑞明	M
孙希望	M
杨雪松	M
李鹏飞	M
徐礼根	M
都政伟	M
张昊炎	M
王新月	F
高海沧	M
张帅	M
田磊	M
范秋雅	F
邱双双	F
徐伟跃	M
周卫星	M
钟巍	M
陈莉	F
薛会有	M
刘陈成	F
刘晓	F
邵兴华	F
陈树兰	F
尹南海	M
张威	M
史分明	M
金芳	F
吴胜利	M
张红光	M
余乐荣	M
谭建兵	M
邓金花	F
崔琛	M
陈倩	F
王林涛	M
单松长	M
仝俊丽	F
田宇航	M
李海玉	M
陈家鸣	M
姚明松	F
陈林林	F
陈莎莎	F
梅竹	F
林亚聪	F
李刚	M
陈志刚	M
张国甫	M
钟涛	M
朱允杰	F
姜军涛	M
刘卫林	M
吴炜	M
罗邱洋	M
陶闯	M
范阜东	M
刘雅娟	F
黄才晏	M
安红	M
赵梓良	M
刘平生	M
张信忠	M
朱胡平	M
李萍	F
邓鹏飞	M
张襄娟	F
宣叶飞	F
陈明珠	F
董明旗	M
陈家营	M
郝家富	M
钟旭	M
易海兰	F
周文娟	F
马晶晶	M
项亮军	M
王影	F
曹东旭	M
李凯旋	F
刘明明	F
邹永文	M
彭远超	M
刘龙祥	M
梅奇峰	M
朱红月	F
章晓燕	F
阮文强	M
杨宗敏	M
沈智慧	F
尤爱苗	F
陈兰	F
陈荣华	M
陈江华	M
王长义	M
张春桥	M
唐燕	F
叶剑飞	F
张杰	M
秦旺	M
张振龙	M
屈明瑞	M
王浩	M
常来阁	F
许洪鹏	M
郭鹏飞	M
路根宝	M
文武军	M
范骏	M
马令	M
马盼盼	F
陈春燕	F
叶素琴	F
朱新宇	M
陶琪琦	F
于文亮	M
何金	F
伍大妹	F
李继孔	M
陆尉	F
朱婷	F
陈晶涛	F
俞珏	F
祝小花	F
袁佳萌	F
赵萍	F
张红卫	M
罗发桂	F
熊件水	M
邓淑兰	F
宋国花	F
顾洪奕	F
罗国平	M
孙朋	M
李文锋	M
郑东风	M
康旭东	M
许焦波	M
熊荣胜	M
张正梅	F
吕超	M
王雷	M
韩宝珍	F
郭淼	F
张飞飞	F
杜会芳	F
杨立君	M
刘家龙	M
吕锦	M
张祥雨	M
高斌	M
耿广发	M
杨丽娟	F
汤寻飞	M
马丽	F
邹林辉	M
刘小龙	M
陈博	M
许燕燕	F
曹江辉	M
李徐珊	F
郭二霞	F
冯青苗	F
沈雁冰	M
董宝山	F
张艳琴	F
陈正荣	M
荆迪	F
姚向阳	M
洪亚波	M
徐迪	F
过丹红	F
汪珍玉	F
刘彬	M
李信辉	M
马锦锦	F
黄奇文	M
侯威	M
聂锋	M
齐松	M
蔡伯诚	M
王凯伟	M
周红英	F
苏海胜	M
王文琪	F
宋海峰	M
李敬	F
杨亚军	M
严飞江	M
丁光顺	M
熊丽英	F
戴松林	M
郭启辉	M
徐方谅	M
张炳权	M
万福龙	M
闫旭东	M
石浩霖	M
王杨	M
王诚	M
黄雪红	F
詹婷婷	F
张丽	F
任杰	M
刘悦	F
闻丙煌	M
周浩楠	M
张艳山	M
耿湘滢	M
亢湛皓	M
廖灿南	F
王平	M
曾剑	F
周继勇	M
何基亚	M
王荣健	M
侯松德	M
徐睿健	M
胡和庵	M
胡平	M
黄宗恒	M
吴保利	M
高凯	M
刘天硕	M
姜斌	M
韩明	M
邓冯军	M
水清清	F
孟祥平	M
白小虎	M
丁洁	F
王凯	M
庞博中	M
汪萍丽	F
余江海	M
周达兵	M
黄云鹏	M
李长为	M
刘秀锋	M
梁齐斌	M
董泽林	M
张朋	M
熊梁	M
占新祥	M
刘帅	M
李戡	F
易红艳	F
郭学顺	M
孙海	M
王开芬	F
常丹丹	F
张正国	M
樊英英	F
林萍萍	F
孟素玲	F
谭舒文	F
张小林	M
王晓梅	F
涂继春	M
夏小明	M
徐昭欢	M
张志鹏	M
黎金照	M
陈琼慧	F
何家慎	M
沈倩	F
唐超栋	M
王萌	M
张海健	M
龚婷婷	F
吕红影	F
李旭	M
张佳伟	M
李祥子	M
赵锦刚	M
方钰玲	F
洪丽燕	F
刘水英	F
何鑫	M
周炎	F
潘凌翔	M
郑春梅	F
陈其君	M
李晓楠	F
郑琴	F
汪卫平	M
阮建新	M
梅海霞	F
寿丽蒙	F
张浩	M
代向洋	M
曹梦颖	F
邓荟芬	F
邵珠恒	M
申小鲁	F
陈宪龙	M
万桂	F
蔡晔	M
杨杰	M
张志	M
龚爱凤	F
沈宁飞	F
万飞勇	M
麻万排	M
陈丛	M
吉安	M
周子翔	M
王娇娇	F
吴丰廷	M
潘江凌	M
王可可	F
王路楠	F
王孝微	F
张坤坪	M
陈华	M
黄竹英	F
叶苏娣	F
武东安	M
周昊	M
赵南燕	F
唐松林	M
竺元恺	M
陈帅坤	M
尚三妮	F
毛颖风	F
姚开安	M
李省道	M
罗虹	F
马金梅	F
刘叶	F
李敏	F
孔融融	F
刘素新	F
王茶仙	F
俞其峰	M
彭志远	M
李艳春	F
胡云鹏	M
敬晨	M
郑红明	M
陈秋儿	F
秦蕾	F
贾少杰	M
刘兴林	M
詹建伟	M
贾秋辰	M
张骥轩	M
邢孟闯	M
李武国	M
谭昌兰	F
胡荣勇	M
凌丽霞	F
宋乃运	M
屈国胜	M
马心超	M
赵宏松	M
许燕	F
魏鹏	M
丁坚	M
黄振华	M
万礼江	M
王增杰	M
黄红耀	M
成球则	M
许超	M
余霞	F
李宣超	M
李军	M
朱嘉煜	M
孟祥辉	M
阮金燕	F
王传恒	M
骆晓康	M
刘震云	M
黄春存	F
杨美昆	M
朱一滢	F
王泽芳	F
桂娇娇	F
昝玉	F
杨倩	F
许柳城	F
胡丽芳	F
范俊华	F
熊海涛	M
白振	M
雷星星	M
王淞	M
钟玉华	F
毛园坚	F
刘益平	F
陈娟	F
李红斌	M
俞萍萍	F
帅文均	M
贾龙旭	M
张科丽	F
吴微峰	F
杨娇	F
吕诚	M
黄涛涛	F
张晓红	F
陈如意	M
谢仕维	M
郭昊昊	M
章泽	M
潘金霞	F
刘兵	M
潘洪飞	M
孟凡东	M
周珊珊	F
郭素琛	F
赵科	M
李瑞勇	M
吴小军	M
刘引莲	F
李超琪	F
梅玲飞	F
杜顺发	M
孙小青	F
黄琴	F
吴杰	M
任青霞	F
杨海彤	M
袁勇杰	M
朱云峰	M
谢富祥	M
谢玉红	F
沈婷婷	F
何海燕	M
魏思田	M
巩玉杰	M
游建锋	M
彭青秀	F
何开宝	M
虎群燕	F
罗华妹	F
龚世乐	M
薄传海	M
刘振宇	M
朱霖	M
梁双四	M
吴丹	F
陈大凯	M
章旭东	M
赵梦丽	F
汪群亚	M
郑海燕	F
左超群	F
刘仲成	M
丁国东	M
丁亚鹏	M
李仁林	M
王小棉	F
戚兰英	F
徐登杰	M
张波云	M
黄天华	M
蒋春燕	F
马成龙	M
麻福贵	M
麻赛个	F
杨天将	M
曾小娟	F
逄润玮	F
宋霞	F
娄丽娜	F
金敏芳	F
李海君	M
许炳	M
阎世英	M
吕杰	M
廖哲永	M
邵冲	M
李鸿禹	M
韩云生	M
客凌伟	M
李青青	M
曾龙飞	M
尹向前	M
王转辉	M
孟治远	M
李涛	M
赵永英	F
高瑶	M
金国荣	M
张春骏	M
王宇清	M
胡敏霞	F
谢友芬	F
李小敏	M
王建	M
张健芳	M
单兴梅	F
吴佳钉	M
孙维娜	F
俞亚萍	F
林选丰	M
邓思源	F
桑瑞瑞	F
刘广立	M
李继红	F
邱晓波	M
虞超凡	M
夏良斌	M
徐丽	F
蔡晓琴	F
唐菊花	F
宋云华	F
郑媛	F
涂传纺	M
胡蓉	F
蔺发坤	M
钟磊	M
袁子雄	M
汪波	F
金海峰	M
丁付中	M
肖德园	M
叶家辉	M
丁朝琼	F
魏兰花	F
蔡爱国	M
杨孟杰	M
黄书悦	M
沈文彩	F
魏建亚	M
张伟	F
倪爱民	M
罗永芳	F
冯杨博	M
陈坤	M
陈旭	M
祝娟	F
唐英龙	M
赵嘉晴	F
马晓军	M
沈雪冰	F
崔鑫	M
徐娟	F
淦述齐	M
蒋凤英	F
彭晓燕	F
张鑫	M
鲍燕芯	F
李月	F
王云波	F
闻引	M
李艳莉	F
唐小琴	F
王吉如	M
王艳	F
张江飞	M
朱立君	F
常权	M
贝家鼎	M
冯烨炯	M
申威强	M
朱莉莉	F
刘诗福	M
张功彬	M
陈红辉	M
邓思琴	F
吴振宇	M
王洪艳	F
马艳梅	F
俞恬鑫	F
郑雅	F
王欣	F
李东生	M
王雪	F
汤浩	M
贺行杨	F
麻俊杰	M
毛咪娜	F
严克鹏	M
廖兴丽	F
刘婷	F
曹凤英	F
陶学惺	M
沈祖兰	F
范家浩	M
丁纪俭	M
张丽江	M
龙印	M
赵俊霞	F
彭浩	M
罗兆斌	M
周章亮	M
杨迎宾	M
孙元召	M
董学辉	M
周树琴	F
严志宏	M
何赤华	M
马恩霞	F
李瑞瑞	F
李安柱	M
王永淑	F
钟清华	F
邓振龙	M
周彩萍	F
龙浓	M
黄明雍	F
陆奕林	M
徐万华	M
周桂娟	F
庄学珂	F
沈钰	F
张井庶	M
王立柱	M
周仕华	F
周跃民	M
赵晓玲	F
王世聪	F
吴昊天	M
邵明喆	M
位俊杰	M
徐家辉	M
金海波	M
肖淑梅	F
冯佳笑	F
潘怡缘	F
张嘉浩	M
吕鹏	M
劳得轮	M
田华	M
李迎香	F
杨小诺	M
杨知英	F
曹冬辉	M
丰江	F
项湘平	M
张昌荣	M
李春英	F
李海龙	M
徐斌	M
杜雄	M
李天伦	M
何贤锋	M
刘书月	F
彭建均	M
王才敏	F
李国庆	M
马朋	M
张莉	F
常荣成	M
孙立娇	F
毛杨清	F
徐丽丽	F
王路辉	M
王大奎	M
单燕	F
钱君	F
黄勇君	M
陈波	M
程杰	F
吴双喜	M
刘学良	M
杨金辉	M
喻臻翔	M
欧阳圳荣	M
陈玲	F
马学礼	M
方颂	M
杨鹏龙	M
李少鹏	M
顾明生	M
张思纬	F
陈小龙	M
朱盼	F
宋军博	M
杨守英	F
李艳	F
于佰瑞	M
敖晶晶	F
雷笑云	F
张建立	M
徐洪勇	M
薛立波	M
张伟伟	F
朱丽	F
张梦楠	M
姚一力	M
尤晓青	F
邓红	F
徐慧洁	F
陈优达	M
吴相峰	M
彭国雄	M
白江通	M
张福贵	M
余瑛洁	F
陈娟霞	F
李敏敏	F
黄晓丽	F
张明凤	F
董腾彪	M
吴华斌	M
华南钧	M
管海波	M
马梅	F
杨绡	F
张英	F
屈海刚	M
柴祥龙	M
钟珍明	M
吴丹	F
张镭	M
郑雨璇	F
张永和	M
王伟涛	M
苏华	M
程功	M
徐敏超	M
冉庆稳	M
张亚龙	M
高光丽	F
吴海龙	M
汪心定	M
毛燕燕	F
熊寅鹏	M
张春龙	M
杨聪聪	F
陈璐	M
唐建伟	F
许恒	M
周佳敏	F
丁成立	M
王嘉瑜	F
卓琼妮	F
彭贵	F
罗迪	M
储维养	F
魏章波	M
刘斌	M
杨汶婷	F
刘世松	M
李肖肖	M
陈旭意	F
周琦	F
王俊霞	F
童佳乐	F
王颖洁	F
何述碧	F
董纪冰	M
杨燕	F
雷落元	M
何象芳	F
李春艳	F
段佳红	F
郁柯欣	F
陈邦龙	M
邓子健	M
桑杰措	F
耿岩	F
王建宝	M
方玲	F
胡天俊	M
刘金娜	F
施培琪	F
李磊	M
熊益达	M
江民	M
祝倩倩	F
田梦婷	F
李振明	M
李丹	F
吴林莹	F
陈博	M
盛一鸣	M
龚银峰	M
尤双燕	M
何志鹏	M
桂成喜	M
黄爱兰	F
陈锋	M
全国林	M
金军	M
陈鹏	M
马娇	F
陈艳荣	F
张文建	M
吴宇	M
沈伟涛	M
陈倩	F
高卓燕	F
刘珊珊	F
傅晶金	F
戴秋蓉	F
王保锋	M
鲁三侠	F
王开东	M
何学文	M
方祖伟	M
邓江	M
王赵富	M
仇裕星	M
彭刚	M
王冬立	M
陈世伟	M
刘海燕	F
兰鑫	M
秦浩添	M
刘彪	M
陈俊	M
罗诗旗	M
梁东海	M
罗应	M
刘巧歌	F
余晓密	F
赵冬梅	F
毛佳	M
刘亮	M
洪纯	F
王惠惠	F
黎猛	M
陈契卫	M
孙洁	F
路远	F
宋志臣	M
俞璐瑶	F
陆艳丹	F
陈涛	M
江红	M
胡柿宝	M
孙鹏	M
汪青媛	F
张青燕	F
赵孟杰	M
滕振宇	M
王凯	M
黄依琪	F
王乐堂	M
杜强二	M
楚光正	M
聂小龙	M
王会丽	F
靳乐乐	F
苏丽	F
邱瑞良	M
代景群	M
宋本成	M
王国朋	M
李兵	M
洪开贵	M
徐忠亮	M
周华	F
石孝强	M
赵青	F
杜晨雷	M
孙一水	M
黄孟孟	M
王志超	M
张贻坤	M
张静茹	F
张纪勇	M
张学如	M
张金波	M
徐桂业	M
荆楼	M
赵楠	M
王金凤	F
潘兰	F
吴刚	M
张晓霞	F
尧林伟	M
孟婷	F
叶雷	M
郭金刚	M
吴静	F
晏磊	F
林思思	F
周勇	M
朱梦佳	F
孟轲楚	M
谢玉婷	F
陈淑芬	F
李成龙	M
张超	M
任来君	F
刘康	M
蹇维强	M
张敏敏	F
陈贺东	M
吴仁飞	F
龙明英	F
胜海顺	M
陆挺	M
马金红	F
徐允锠	M
李占红	M
姜晴	F
张彪	M
汤莉萍	F
高田平	M
张赟	F
宁慧娟	F
苏姚娟	F
姜倩倩	F
郭春进	M
陈露露	F
吴振先	M
何文静	F
马贺	M
罗忆文	F
王伟	M
周运运	M
邢俊朋	M
高玉双	M
毕丹	F
任雪芳	F
高丽	F
朱威斌	M
闻云霄	M
贾园超	F
王银	F
孙向勇	M
杨秀萍	F
胡世龙	M
罗梅梅	F
夏飞乐	F
刘连静	F
王军锋	M
沈亚萍	F
吴保珍	M
余李武	M
董红伟	M
胡棕华	M
宋朋杰	M
杨明珠	F
游佳	F
黄靖宾	M
郑折	F
严云钟	M
王毓河	M
赵辉	M
聂连鱼	F
许惠菊	F
诸宁栋	M
钟玲	F
彭林楠	F
虞祖杰	M
陆敏学	F
徐万玲	M
王玲玲	F
刘成	M
刘斌	M
罗珊	F
张美成	M
张川	M
杨倩	F
李晓燕	F
况永辉	M
王英南	M
潘月健	M
贺美平	M
唐秋龙	M
刘青辉	M
张斌	M
王亚辉	M
李亚明	M
言克强	M
战立斌	M
张迪	F
叶婷	F
王莹照	F
陈凯	M
陈星	M
翟基宇	M
张羽	M
康正勤	M
那明坤	M
张鑫	M
高云鑫	M
孙羽志	M
朱立丹	F
唐新星	M
陈水花	F
王辉	M
李登	M
辛宏斌	M
王东京	M
姜甲琴	F
侯文康	M
张勤	F
沈姣妮	F
潘莹莹	F
窦洪岩	M
张春洋	F
王瑞仲	M
秦维亚	F
姜东	M
张双志	M
李晓妃	F
雷飞	M
熊帅	M
李红娟	F
刘强	M
窦月飞	M
周建清	M
黄亚平	F
刘玉超	M
周立萍	F
周阳	F
余丽萍	F
张云涛	M
朱盛想	M
胡刚	M
邹成龙	M
李妙飞	F
靳改莲	F
旷宁宁	F
张景艳	F
朱双慧	F
张东谋	M
杨乐	M
赵亚娟	F
李杰	M
黄小芝	F
张国新	M
魏珊珊	F
金四利	F
陈小勇	M
李福宾	M
伍仕勋	M
龚雨欣	F
王岗	M
余甜	M
马关向	M
李关洪	M
张香铃	F
高明利	M
郭金龙	M
李树	M
王保平	F
余婷婷	F
杜立利	F
陈帅彤	M
陈炎峰	M
彭南蓉	M
陈玲俏	F
黄梦仙	F
叶玲	F
任伟	M
张梦翱	M
付蕊	F
卢张波	M
朱占宏	M
王学文	M
肖碧云	F
彭姗	F
闫莉萍	F
钟用斯	M
刘渊	M
黄飞能	F
李青松	M
李森	M
刘国伟	M
杨辉	M
谭仕建	M
傅磊	M
方倍云	F
王艳辉	M
何春晴	M
闻超迪	M
韩玉	F
陈洁	F
蒋佩佩	F
周欣	F
吴红艳	F
张建	M
张松	M
凌飞	M
吴卫兰	F
赵小明	F
曹红荣	F
李丽娜	F
许俊男	M
胡有根	F
高曦	M
张秀颖	F
张艳	F
李永阳	M
张银晟	M
董宏梅	F
柏松	M
田飞国	M
谭永秋	F
王智	M
陈燕敏	F
陈斌	M
叶梦莹	F
聂剑	M
李亮	M
杨婷	F
郭智强	M
徐韶君	M
卢佳美	F
何鑫	M
王宗平	M
张婷婷	F
许勇	M
何紫梦	F
陈利锋	M
胡春生	M
李水华	F
周盛宏	M
王军	M
黄顺连	F
杨春洪	F
蓝小芳	F
王卓	M
高博	M
杨俐	F
刘梦奇	M
王兆胜	M
成福兰	F
吴建焕	F
周若敏	F
陈化勇	M
余武勇	M
魏年森	M
周梦杰	M
窦瑶瑶	M
况风香	F
闫朗	M
纪维维	F
李艳	F
高金龙	M
徐玉凤	F
刘林	M
刘长茅	M
王海良	M
杨朝英	F
刘博瑞	M
雷龙霞	F
秦立珍	F
王俊芝	F
李梦雄	M
柳敬	M
吴小红	F
胡文雅	M
杨婷	F
牛丽霞	F
马亚辉	F
马德龙	M
张静国	M
夏巧云	F
胡永康	M
陈晓辉	M
黄宝生	M
罗嗣棚	M
陈明	M
蔡灿武	M
涂东寅	M
何兰玉	F
温燕飞	M
孙秀英	F
王益	M
赵文豪	M
金华金	M
项利超	M
张兰	F
陈旭良	M
刘次菊	F
石松梅	F
鄂小杰	M
张聃	F
张华健	M
梁明	M
郑仿仿	F
余欣欣	F
应莉娟	F
沈佳慧	F
鲍玺羽	F
周灿	M
肖江南	M
杨雪艳	F
刘珂粽	M
窦姣	F
杨凯莉	F
管建明	M
陈明丽	F
李健超	M
吕建	M
龚小强	M
侯亚楠	F
毛阿色	F
唐洋江	M
柴卫府	M
钱国华	M
王啸啸	M
陈普材	M
周月强	M
陈梦婷	F
李冲	M
杨银业	M
田林云	F
周彪	M
陈海松	F
韩宇泽	F
艾智科	F
刘天宝	M
陈丽霞	F
郜福来	M
贺非非	F
王中臣	M
熊惠云	F
胡其琨	M
车广东	M
韩力荣	M
张娅	F
周计家	M
安聪聪	F
叶丹霞	F
唐成念	M
杨小红	F
桑伟勇	M
包佳丽	F
李俊佶	F
杨新星	M
李洁	F
姜雅坤	F
刘亚珍	F
黄梦瑶	F
史君龙	M
郭春红	F
阮帅	M
冯科	M
黄世国	M
万娜	F
喻庆喜	M
王秀青	F
黄孟楠	F
杨春要	M
李红艳	F
敖立邦	M
樊博	M
庞可林	M
胡仕名	M
季双龙	M
卢蓉	F
张汉波	M
秦晓晖	M
涂序洪	M
陈卫红	F
杨宗凯	M
周瑶	F
白桂凯	M
王培	F
董珍霞	F
邱艳军	M
刘文亮	M
刘清云	F
王永娣	F
李光云	M
曹原阁	M
杨琦敏	M
陈利萍	F
黄海金	M
冷旭	M
周金燕	M
乔林娟	F
谭家伟	M
刘望	M
虞晓栋	M
田国喜	M
贾国均	M
姚学宇	M
章模媚	F
杨子伟	M
邹倩	F
刘迎春	M
许高来	M
贾彦龙	M
何小艺	F
吴赛薄	M
张旭初	M
宋世映	F
冯廷锋	M
王文豪	M
赵斯萱	F
林陈培	F
申宏敏	F
魏晨颖	F
孙嘉遥	F
刘珊	F
杨宁	M
张友超	M
方伊君	F
李寿兵	M
李江北	M
刘小兵	M
黎紫金	M
王金豹	M
周斌美	F
葛偞	F
秦中海	M
曹洛清	F
顾佳梅	F
毛佳佳	F
陈聪	M
黄祥军	M
鲜玲英	F
周梦芮	F
庄培玲	F
陈广辉	M
王先平	M
李庆杰	M
吴伟伟	M
王承前	M
李俊亚	F
李旭东	M
王丽	F
柏海丽	F
张震	M
徐海涛	M
赵梦雨	F
许宁宁	F
吴利冬	M
王伟明	M
李徐伟尧	M
雷世兵	M
洪毅凯	M
罗伟成	M
姚兰	F
王志杰	M
赵凯琪	F
卢志	M
米民东	M
陈茹雯	F
陈利伟	F
高云华	M
易志梅	F
朱小叶	F
朱小花	F
段路路	F
夏昌英	F
石月霞	F
陈梦瑶	F
杨海涛	M
王煜	M
张娇	F
田鑫	M
孔瑶瑶	F
郁正清	M
潘亚琳	F
张思	F
田宇	M
姜志斌	M
李静	F
杨亚灵	F
金秀玲	F
唐立勋	M
于燕杰	F
陈泽宁	M
王大凤	F
顾跃进	M
仇小明	M
王岩	M
刘年芬	F
杞朝珍	F
李天荣	M
聂小春	M
高恒	M
都召	M
杨桃	F
郭元新	M
陈超	M
刘强君	M
张祺	M
张潇贤	F
陈之琼	F
汪新星	M
孙丞	M
张海燕	F
刘玉	F
刘春桃	F
葛飞鹏	M
李一飞	M
陈永彬	M
付之美	F
杨仙钟	M
齐航	M
林文栋	M
谢亮	M
甘云	M
张中强	M
武俊民	F
李雪梅	F
赵胜义	M
毛鸿雁	F
王桂花	F
徐飞燕	F
钱欢	F
彭涛	M
姜普	M
俞力琳	F
邱爽	M
汤超杰	M
叶爱琴	F
李锦	F
张晓蕊	F
冯佳丽	F
刘刚	M
卢杰	F
吴嘉祺	M
冷凤	F
裘晓倩	F
徐浪浪	M
马建国	M
姜照雷	M
赵淑慧	F
陈柳悦	F
郭帅	M
潘菁	F
董吴闽	F
陈胜	M
罗秋岗	M
刘艳清	F
靖鹏飞	M
郑镇优	M
周璇	F
占月月	F
韦来	M
李丹丹	F
田中优行	M
钟红辉	M
彭小林	M
王郁	F
周花平	F
施金金	M
周春峰	M
付磐	M
铁经珠	F
邱佳丹	F
瞿名媛	F
戴国飞	F
章慧心	F
滕月红	F
郑云秦	M
钱丹阳	F
郑挚友	M
姚幼红	F
郑露琪	F
容琴芳	F
谢庆	M
刘佳君	M
于飞	M
华麒	M
孟秋阁	F
吴保喜	M
刘少龙	M
沈可杰	F
李欣阳	F
陈绮林	F
李宏亮	M
杨仙蓉	F
王亚军	M
刘晓莉	F
关蒙阳	M
梁德鑫	M
李丹妮	F
杨亚娟	F
江静	F
赵子文	M
张海鹏	M
张玉旺	M
袁继鲁	M
李飞飞	F
陈玲琳	F
杨彦军	M
何鹏	M
方珂平	M
任彬斌	M
宋关江	M
高敏	F
芦惠芳	F
孙铃萍	F
丁颖颖	F
吕汉锋	M
应敏敏	F
杨水龙	M
王奎	M
赖弥兴	M
郝思嘉	F
刘亚丽	F
陶春丽	F
王新丽	F
潘丽晨	F
李锦瑜	F
甘露露	F
贺慧慧	F
洪小燕	F
年四明	M
徐自豪	M
崔璨	F
魏家欢	M
王文地	M
屈佳莹	F
陈新炎	M
包诗柯	M
曾艳敏	F
张弛	F
张晓倩	F
赵栋梁	M
王涵智	M
牛永生	F
龚覃彦	M
尚光松	M
周佳伦	F
夏一丁	F
舒虹雨	F
苏文	F
张占梅	F
虞朝贵	M
胡启亮	M
刘楠	M
高祥娟	F
黄星容	F
王军良	M
姚佳	F
高涛	M
郝玲玲	F
龚钰婷	F
李艳娜	F
杨洁2	F
王世科	M
胡利春	F
邢铁峰	M
孙佳丽	F
曾剑坤	M
卢孝平	M
章华妹	F
包康佳	F
姚凯	M
许冰钰	F
蔡新君	F
赵玉	F
徐杰	M
金敏娇	F
冯朝彬	M
金取	F
杨玉波	F
张枫	M
李娜	F
术术	F
陈海峰	M
张萍	F
王家豪	M
徐超	M
吕炜蜜	F
高云霄	F
汪健	M
唐玉芳	F
李东杰	M
强栩	M
李梦飞	F
王威洲	M
张美芹	F
朱亚茂	F
宗涛	M
蒋力	M
何晶晶	F
李燕萍	F
杨鹏	M
季佩璐	F
王丽文	F
钱丽佳	F
王智慧	F
孙春航	M
谢冲	M
李杭	M
万首	M
聂苏有	M
朱振彪	M
路建	M
娄瑞	M
乐妙莉	F
黄义仙	F
王泰强	M
陈描	M
徐国栋	M
朱珠	F
黄莹莹	F
王静	F
虞飞月	F
毛云涛	M
姚露雅	F
黄婷	F
莫佳倩	F
樊咏梅	F
刘俊杰	M
刘彩平	F
杨梦	M
李飞	M
范敏霞	F
谢志成	M
李佳琪	F
李瑞琪	F
余义芳	F
何亮	M
万佳锋	M
李燕萍	F
沈露莎	F
沈珊珊	F
李凌丽	F
刘婷	F
陈尘若	F
孙晴晴	F
黄皓	M
贺佩佩	F
张莉	F
刘小青	F
韩庆亮	M
李杭烽	M
邹兰生	M
舒晓伟	F
陈江林	M
周玉兰	F
徐升磊	M
刘姝慧	F
张雨晴	F
徐丹	F
严张梨	F
陈磊	M
陈通进	M
吴敏	F
程美玲	F
刘丹杰	F
赵志新	M
王三苗	M
李蓬勃	M
周凤姣	F
郝小江	M
张定红	F
彭冬冬	M
李兰桂	F
林忠洲	M
马洋洋	F
张斌斌	M
蓝嘉媚	F
米光超	M
晋延蕊	F
李小菊	F
陈立	M
黄轶贤	F
魏小翠	F
涂传辉	M
涂传连	M
丁飞辉	M
谷锦立	M
余安远	M
曹庆强	M
胡艳楠	F
王春雨	M
杨振超	M
王雅昕	F
李新丽	F
肖琼琼	M
王天垚	M
陈玲	F
徐润友	M
叶雅萍	F
张二飞	M
王苏玲	F
宋磊	M
钱永恒	M
施祝良	M
邵晓丽	F
李松林	M
程佳浩	M
王水根	M
余小华	F
高香	F
余功仁	M
周丹	F
冯亚龙	M
张帅军	M
张华乔	M
吴朝红	F
杨亮	M
王芳	F
毛翠	F
谢武辉	M
李倩	F
王鹏	M
丁夷	M
吴勇杰	M
雷孔欣	M
李淑芳	F
杜晨	M
范广举	F
雷云	M
夏雨明	M
杨元枝	F
胡家军	M
杨崇笑	M
高样军	F
张江艳	F
王光荣	M
龚玉婷	F
宋嘉瑶	F
余文燕	F
康旭伦	M
陈孝平	M
熊红梅	F
陈友华	M
邱娟	F
马佳寅	F
李可欣	F
杨挺	M
李松涛	M
樊春花	F
朱惠桃	F
刘骏	M
吴金津	F
张欣	F
张丽春	F
谢莹	F
王少伟	M
李海智	M
涂桂平	M
陈敏	F
陈青霞	F
廖聪	M
金功妹	F
汪洋	M
杨超	M
谭国建	M
丁树峥	F
南福乐	M
郭彬	M
韦发健	M
马腾	M
杨思	F
庆铭洋	M
王阳杨	M
岑超钦	M
李增光	M
涂传辉	M
王海华	M
刘雅茜	F
陈彦宏	F
刘国伟	M
任海艳	F
殷志荣	M
丁迎媚	F
史鲁杰	M
邓花	F
易东昌	M
张勇鑫	M
董勇	M
秦争营	M
傅江明	M
石旻昕	M
张益民	M
涂永辉	M
汪振宇	M
刘秀梅	F
张述恩	M
沈晓虎	M
方晓波	M
翟周锦	F
王维月	M
袁晓牧	M
陈再智	M
李业华	M
奚璐璐	F
龙军	M
肖华	M
林超然	M
王洪强	M
张德林	M
李留留	F
周永余	M
王金霞	F
刘程	M
肖琴芬	F
许怡冰	F
殷艺雯	F
张豌婷	F
朱红晶	F
何雪菲	F
艾则孜艾合麦提江	M
李景琦	M
刘雪冰	F
李树飙	M
邓林花	F
方晶华	M
吴正德	M
牛花朵	F
王淑珍	F
冯玲	F
祝招兰	F
阳黎波	M
刘静	M
史贤唐	M
李健	M
洪威	M
卢晓慧	F
林铃	F
谢建华	M
陈永林	M
周亚萌	F
周海燕	F
唐朝英	F
杨雷	F
袁建华	M
纪德喜	M
鲜梅林	F
龙章财	M
杨传付	M
徐冰心	F
胡海丽	F
李倩倩	F
王双	M
卓乾宏	M
蔡文文	M
梁鑫	M
陈明华	F
易云龙	M
马超君	F
胡笳远	M
周定清	M
苏宇飞	M
陈卫龙	M
应建明	M
牛苗苗	F
李洪永	M
刘栋栋	M
余良杰	M
曾亚萍	F
熊信龙	M
赵柯明	M
王树圣	M
孔月	F
田振	M
王青坤	M
岳阳	M
丁一	M
魏俊红	F
武浴民	M
李冰	F
徐德鑫	M
宋涛	M
龚维娜	F
姜朋举	M
丁宏玲	M
黄淑琴	F
蒋明安	M
崔云	F
李佳乐	M
忻科伟	M
张花	F
武云龙	M
杨宣	M
竺熔	M
鲁旻	F
潘纯之	F
陈光	M
张其虎	M
付瑶	F
郑五洋	M
沈纯梦	F
杨贵荣	M
王丹丹	F
任锂琴	F
缑东元	M
张仁泉	M
范仕翠	F
商书亚	F
何明兰	F
朱燕惠	F
沈淑英	F
崔成宏	M
金斌林	F
唐晶晶	F
李涛	M
吕佳敏	F
倪家好	M
杜祯玉	F
岑瑶	F
杨雨凡	F
余雪华	F
郑嘉尉	M
康清欢	M
陈莉敏	F
屈倩倩	F
彭娇	F
王方贤	F
马毅强	M
李寒生	M
汤永华	M
冯小龙	M
陈晶莹	F
程静静	F
陶传龙	M
张迪	M
郑继祥	M
苏荭	F
兰钰杰	M
陈龙军	M
刘素雅	F
李海龙	M
何丽	F
安海涛	M
梅月月	F
郭海玲	F
王佳	F
朱世荣	M
孟伟	F
张淼	F
陈圆	F
梁娜	F
宣明儿	F
史晴晴	F
林小龙	M
胡阿强	M
项敏敏	M
谢丹妮	F
张洪侠	F
沈碧瑜	F
涂发廷	F
马智敏	F
冯峥峰	M
唐杰	M
邵静	F
葛春根	M
曾伙娇	F
张建旭	M
雷文	M
何兰芝	F
易菊	F
周国刚	M
陈和昌	M
杨雪毓	M
诸力	M
宋春生	M
卢颖	F
吴华锋	M
陈绍军	M
樊荣俊	M
艾春红	F
全飞燕	F
徐真真	F
周文涛	M
王俊丽	F
李马	M
丁国富	M
吴彤彤	F
陈勤	M
章永霞	F
潘伟慧	F
马艳	F
郭程	M
马宏广	M
汪秀玲	F
朱雨	F
王德道	M
金宝清	F
吴光毅	M
吕旺	M
徐涛	M
杜阳海	M
吴家宏	M
许景先	M
朱建壮	M
范伟斌	M
瞿泽伟	M
罗岗	M
孟遥	M
高海涛	M
屈俊力	M
张文娜	F
许彦芬	F
马越群	F
刘建春	M
斯建	M
何信鑫	F
陈彪	M
吴克	M
陈田	M
刘鹏	M
马高恒	M
李云东	M
吴敬楠	F
夏海琴	F
郭宇豪	M
李云芳	F
张祥军	M
雷雨	M
姜诣戈	M
杨银波	M
胡佩	F
余红珠	F
龚强	M
喻勇华	M
胡桂枝	F
杨秀元	M
何加正	M
冯敏	F
蒋婷婷	F
王云云	F
周核桢	M
游酃南	F
张立立	F
喻平平	M
解冬	M
苏资贻	F
陈克斌	M
梁志贤	M
张鑫淼	F
王青	F
杨丽丽	F
何佳丽	F
任清远	M
王帅印	M
杨莹莹	F
王婷	F
谭金宝	M
陈小兰	F
刘云龙	M
张志	M
张会霞	F
巩顺舜	M
刘广春	M
张平	M
贾璟珺	M
张晶晶	F
胡蓉蓉	F
张宏平	M
姜娜娜	F
郑小平	F
张爱君	F
吴青求	M
王炳钢	M
于家凤	M
张英	F
孙燕	F
郭靖	F
刘郑	M
毛巧鑫	F
郭文文	F
余泳娇	F
马培培	F
徐国良	M
李雁蓉	F
张瑶	F
刘红贞	M
胡忠齐	M
彭绍迪	M
张强	M
骆光梅	F
刘朝光	M
徐淑连	F
王丽峰	F
郑潇雅	F
白兰	F
沈慧	F
高花	M
李彦茹	F
高英	F
王乐明	M
杨柳	F
王丹凤	F
聂宽平	M
朱超界	M
杨娃萍	F
李阳	M
朱未姿	F
孙忠刚	M
吴勇	M
陈国连	F
黄婷婷	F
潘海洋	M
田闯	M
张春奎	M
张秋利	F
姜留涛	M
袁小军	M
厉为良	M
张吉波	M
何彦伟	M
陈晓玲	F
刘双虎	M
万芳	F
单琦	F
孙抗抗	F
舒爱军	F
王章霞	F
茅琰青	F
章强	M
卢佳祺	M
谢栋琪	M
戴红艳	F
张先富	M
严祥辉	M
郑天扬	M
戴柳慧	F
魏妍	F
刘卫东	M
王建萍	F
吴光敏	M
张炎	M
魏如意	M
陈奇	M
章复仁	M
周理想	M
徐微微	F
印倩倩	F
陈姣姣	F
应玲芝	F
冯杰	M
杨斌	M
方莹	F
夏丹娜	F
饶怡清	F
张萌	F
陈曼玲	F
陈芙蓉	F
陆淑蓉	F
刘剑	M
楼珍珍	F
王婕	F
罗彭霞	F
马艳雨	M
任小然	M
方超	M
马欢	M
陈彩风	F
赵芯晏	F
王舒婷	F
沈丹怡	F
王巧倩	F
徐志伟	M
吴佳玲	F
卢定芬	F
郭美娟	F
刘昌厚	M
王炉波	M
梁再祥	M
李伟康	M
徐非凡	M
黄依园	F
蒋宁璐	F
王奕	F
孙方华	M
叶孟颖	F
李颂勤	M
史玉龙	M
董正	M
曹久凤	F
邓小华	M
史星伟	M
倪胜仁	M
张楚澜	F
许壮	M
李翱翔	M
孙谱悦	F
覃洪春	F
夏彩红	F
王莎莎	F
池震奇	M
金建花	F
芮斯佳	F
童荣尧	M
王梦	F
赵三保	M
李慧	F
石云	M
杨赞	M
朱雪玲	F
刘素歌	F
何涛	M
李燕	F
朱春强	M
唐超	M
彭影	F
崔佳伟	M
杨刘	M
杨凯	M
曹艳	F
周凯	M
刘颖	M
虞鼎鼎	M
董朝国	M
文奕	M
占陈飞	M
唐海青	M
李唯	F
汤艳玲	F
张景红	F
杨航	M
何海龙	M
马征	M
张雪丹	F
瓦云英	F
尚彩红	F
王彦君	M
姚远远	M
余米仙	F
刘东霞	F
郎九玲	F
项琛	M
王振磊	M
熊美云	F
龚子翔	M
万齐亮	M
龙芸	F
丁玲玲	F
谢宏丰	M
廖志明	M
艾慧光	M
伍仪	F
郝金梦	F
刘书斌	M
杨燕	F
俞美铃	F
吴雅廷	F
毛泽倩	F
郜鹏飞	M
李玉玲	F
刘洋	M
吕泽妞	F
王跃	M
胡攀峰	M
昌智	M
吴月	F
马坡	M
宋丹凤	F
刘鸿宇	M
刘建	M
肖维	M
刘雅	F
马孔斌	M
吴刘芳	F
吕梦琴	F
刘吻	F
车文权	M
王欢欢	M
孙红军	M
彭华祥	M
石银萍	F
刘笑	F
袁冰鑫	F
孟庆宇	F
高学猛	M
陈耿	F
单超龙	M
张豪	M
杨嘉诚	M
孙帅	M
李丹	F
刘细凤	F
马小杭	M
谢军	M
伽书娟	F
魏磊	M
邓泽文	M
黄交文	M
彭正根	M
庞增耀	M
申奥	M
信丽	F
刘洪虎	M
金根香	F
吴国荣	M
胡金花	F
汪海潮	M
谭俊	F
包美琳	F
胡文华	M
蔡景杰	M
于彦荣	F
张云	F
王丽娟	F
陈利新	F
张垚垚	M
刘浩	M
裴朋	M
秦修	F
王亚兵	M
吕文凯	M
葛王锁	M
闫祺蒙	M
陈秀艳	F
燕兆孩	M
刘晓利	F
张单玲	F
魏有客	M
闵尊趣	M
翟龙	M
李学远	M
杨海	M
余海根	M
胡江雯	F
王小刚	M
冀西	M
靳振华	M
肖燕妹	F
张勤锦	F
潘丽洁	F
罗语	F
张洪博	M
桂阳	M
桂立	F
桑瑞杰	M
谢巧	F
王粉	F
林浩	M
张威风	M
陈奇立	M
张利亚	M
林欢	F
吴春苗	F
董秀云	F
梁淑飞	M
陈炜	F
郑永红	F
朱高迎	M
应珺艳	F
傅靖升	M
周锦川	M
汤佳	F
张数	M
邓安泽	M
刘言梅	F
江海波	M
廖吕昌	M
周宇	M
段雪芳	F
陈齐彪	M
徐玉宝	M
程锋	M
王宗	M
张瑞丽	F
高丽园	F
龚波	M
李建永	M
任立君	M
陈楚楚	F
余龙	M
周世兴	M
杨蒙娜	F
邱辉辉	M
李梦迪	F
高宇芯	F
张鹤龄	F
高祥	M
李俊洛	M
李霞	F
王代文	M
王啊玉	F
邱昊	M
李珂珂	M
张怀周	M
马国福	M
刘世杰	M
袁咪	F
戎玉	M
李卫军	M
路厚茂	M
崔依凡	M
孙闪闪	F
肖丽丽	F
谭卓琳	F
英艳松	M
郜振安	M
杨素	F
唐小勤	M
廖欢欢	F
喻文文	M
涂伟伟	M
张茂	M
刘红侠	F
杨俊峰	M
覃健舒	F
李秉正	M
胡祥祥	M
赵书妍	F
秦启瑶	F
李文玉	M
李小秋	M
查盛松	M
杨莉	F
唐瑞清	M
刘思凡	M
夏友保	M
王桃容	F
李小玲	F
胡伶俐	F
陆新颖	M
帅再勇	M
王敏敏	F
龚燕飞	F
乐建彩	F
刘自建	M
刘学令	M
余文龙	M
李国洋	M
梅晓明	M
叶童林	M
何丛军	M
董裕钱	M
梁红梅	F
艾鑫	M
彭胜淑	M
李忠进	M
胡锦	M
湛甲秀	F
梁万全	M
马旭东	M
周文杰	M
杨艳	F
韩雨	F
胡世波	M
何柳	M
程中芳	F
冯小兵	M
叶思春	F
蔡海超	M
王勒勒	M
陈海芳	F
邹容英	F
褚丽	F
马亚梭	M
曾超红	F
钱槐珠	F
罗玉杰	M
杨蕾	F
马闫	F
程琼	F
王俊涛	M
顾时娜	F
金青青	F
李世文	M
钟学良	M
成良何	M
周忠海	M
纪璐璐	F
李恋恋	F
朱帅帅	M
刘颖方	F
朱杭炜	F
权增问	M
李徽	M
艾东贞	M
李永峰	M
罗昭发	M
孔灵芳	F
陈好	M
王建辉	M
叶战平	M
黄智勇	M
乔美嘉	F
姚运雨	M
王桂花	F
郑玲芳	F
王晓晖	M
金清洋	M
湛胜	M
彭君莲	F
吴雅伦	F
王美华	F
尉永珍	F
梅越	F
段祥超	M
陈羽强	M
罗江强	M
杨玲玉	F
叶碎光	M
张杰梅	F
肖兴旺	M
沙占军	M
宋祥福	M
李宪彬	M
吴绍磊	M
王国华	M
李淑琴	F
肖建生	M
刘军芬	F
朱福兰	F
胡红卫	F
徐俊吉	M
赵旭	M
胡金标	M
王雄	M
山洪凯佳	F
汤成松	M
韦建华	M
刘子恒	M
陈雪	F
徐绍新	M
罗通铭	M
刘斌	M
任高荣	M
淡莹	F
张毅叶	F
曹靖	M
史寒健	M
王慧萌	F
胡强	M
郭娟娟	F
阳福平	M
邹梅连	F
唐军	M
马运良	M
田莹	F
张永荣	F
钱嘉强	M
徐飞	M
杨振晨	M
訾正平	M
周代红	M
陈方雷	M
徐鹏亮	M
陈超	M
于世杰	M
熊伯党	M
张欢欢	F
龚庆兰	F
邱根水	M
武学浩	M
杨贺超	M
柴俏璐	F
张明星	M
宋佳俊	M
王文博	M
李海滨	M
冯硕	M
葛鹏飞	M
刘悦鑫	M
贾伟	M
唐海旭	M
崔云辉	M
张超	M
靳卫力	M
申耀强	M
李林梅	F
严雅婷	F
谢腾吉	M
刘晓	F
涂青霞	F
杨瑾	F
付孝娃	F
覃祖一	M
王琪	M
张雪锋	M
卫超	M
邢雨善	M
万凯	M
宫雪彬	M
徐碧花	F
周玮	M
高亚辉	M
张家黄	M
张灿	M
杨总超	M
刘敏	M
马后红	M
胡建国	M
金旭东	M
范友余	M
罗梅	F
胡秀秀	F
袁长城	M
李刚	M
刘芝明	M
任佳彬	M
李子旭	M
刘鹏	M
达军	M
潘文强	M
张理燕	F
谢艳艳	F
胡康	M
周芳蕾	F
肖潇	M
王如意	F
杨自越	F
张映节	F
马金花	F
沙洁雯	F
李龙龙	M
王鑫	M
王建	M
沈磊	M
闫芮	F
秦旭	M
孙军营	M
冯峻	M
李海平	M
郭绍奇	M
郭小亮	M
胡涛	M
李世强	M
张小华	M
袁绪荣	M
张涛	M
张秀岩	M
任亚婕	F
裴峰	M
王浩	M
张来发	M
朱荣波	F
杜若辰	F
徐俊康	M
严佳妮	F
刘聪	M
刘永娟	F
吴燕平	F
刘金凤	F
许立	M
邵月明	M
何园	M
张欢庆	M
傅道辉	M
廖细香	F
林小燕	F
丁浩	M
陈莎	F
熊平英	F
张伟	M
邓香桂	F
雷三连	F
鲍栋明	M
陈叶	M
黄娟	F
陈国飞	F
陈昕	F
白祥启	M
邱叶	F
何艳丽	F
刘斯文	F
柴宽	M
姚枫枫	M
阳志梅	F
贺明燕	F
赵乃荣	M
张国富	M
温泉	M
李玉霞	F
丁雅磊	M
唐英杰	M
何祎	M
孙成阔	M
张赛赛	M
刘国振	M
叶贤武	M
周东运	F
杨勇平	M
张少良	M
张腾	F
郭影丽	F
郭长森	M
高军善	M
张欣	F
俞根华	M
赵雪松	M
唐维	M
徐龙	M
王全刚	M
吴国军	M
杨瑞	F
余泾柯	M
陈松	M
马颖	F
周南明	M
罗金毅	M
戴昊桐	M
潘旭东	M
付小宁	F
张建康	M
曹琳	F
胡明善	M
钱恩军	M
陈俊哲	M
王雷	F
罗飞	M
金小招	F
王贤萍	F
李婉蔓	F
周光铎	M
周久刚	M
周薇	F
马逸	F
邵盈	F
赵倩倩	F
庞晓宇	M
荆磊	M
朱婷婷	F
祁元凯	M
徐其盛	M
王冬威	M
徐梦薇	F
郑姗姗	F
孔珲	M
周亮	M
李金蓉	F
杨艳	F
雷素青	F
王鑫	M
吴永辉	M
李杰	M
何玮婕	F
苏倬敏	M
黄勇军	M
王龙	M
柳巧叶	F
胡志传	M
滕荷英	F
冯选超	M
陈副仁	M
邓振勇	M
郭翠红	F
吴海明	M
岳莹利	F
陈秋林	F
徐祥	M
肖辉	M
苏建军	M
徐飞	M
沈佳璐	F
马武杰	M
张石	M
李留洋	M
刘期远	M
褚立	M
奚天芳	M
雷江海	M
申芳卿	M
赵盛娜	F
朱丹露	F
陆传宝	M
潘虹	F
沈斌	M
张洪凯	M
钟婷婷	F
盛丹妮	F
王龙	M
吴妮娜	F
吕建力	M
郭启望	M
潘春芳	F
张宁	M
汪喜飞	M
陈怀	M
周平	M
梅小珍	F
李文静	F
熊巍	M
丰伟鑫	M
李咱乃	M
蒋夕旎	F
汪蕊	F
陈佳欢	F
刘永权	M
张鹏	M
谢海侠	F
慎辉	M
李纯志	M
李招华	F
张晶晶	F
叶云	M
卢清君	M
王静露	F
胡远彪	M
徐国祥	M
田自豪	M
杨晨	M
郑忆健	M
吴海燕	F
王丽珺	F
吴婷	F
郭聪聪	F
余赛术	M
章鲁波	M
肖会琼	F
陈先红	M
褚江	M
谭亚州	M
徐海丹	F
储伟	F
吴兆亮	M
徐帆	M
包路	M
孙照会	M
曾文艺	M
吴丽芳	F
张思阳	F
杨将威	M
孟利涛	M
毛思思	F
王赛	M
黄炜	M
叶蕾	F
李威	M
潘保远	M
叶超飞	M
林楠	F
王军	M
寇晖	M
杨宗队	M
谭欣	F
王余	M
张盼盼	F
刘明阳	M
符星	M
杨扬	M
沈志荣	M
吴盼	M
田甜	F
吴柠巧	F
周从红	F
张甜	F
徐立米	M
王明	F
夏国军	M
牛晓峰	M
张国政	M
李树贤	F
杨文娟	F
陈华	F
李素贞	F
郑芝娟	F
黄琴	F
戴冬冬	M
耿利华	F
应科杰	M
徐江	M
王维佳	M
夏梓君	M
姜鑫	F
屈向向	M
聂雪军	M
白杨	M
侯泽龙	M
徐水珍	F
尤国生	M
关轶	M
胡军华	M
徐力鸿	F
严斌	M
杜赛赛	F
张天洁	M
郑嘉敏	M
夏智勇	M
曲正	M
郭奂文	F
林婷	F
赵忆璇	F
苏金胜	M
章志恒	M
李慧玲	F
李川	M
李诗琪	F
罗水生	M
熊春荣	M
王新立	F
黄帅	M
刘军帅	M
李瑞星	M
李云龙	M
黄恩锡	M
李秋雨	F
何悦杰	M
陈红光	M
代回昌	F
朱晓雅	F
何艳春	F
蒋亚波	F
雷磊	M
杨翠翠	F
葛霞	F
安然	M
李庚	M
黄涛	M
戚瀚骐	M
章毓庭	F
樊荣林	M
轩朋辉	M
张稳定	M
魏元贞	F
王桂君	M
屈根娥	F
吴水根	M
熊琴	F
韩向彪	M
张岗岗	M
赵龙涛	M
郑智恺	M
倪浩峰	M
张露露	F
何雷	M
胡开刚	M
顾黎恩	M
李云飞	M
林瑞芹	F
龙腾	M
王高昇	M
周学敏	F
刘少康	M
张鹏	M
刘振华	M
张光经	M
姜培	F
滕晓燕	F
陈达	M
张圣涛	M
郭振龙	M
邬颖楚	F
吕国军	M
权永生	M
杨育光	M
李雪玲	F
李梦华	F
董家俊	M
杨芹	F
朱蓓蓓	F
张博辉	M
陈思江	M
简永波	M
鲍作俊	M
陈亚楠	F
邓书勤	F
张桂芝	F
罗琴	F
李平	F
沈云岗	M
陈洋炜	M
王水东	M
伍迎芳	F
张楠	M
何晴	F
杨央央	F
李宇佳	F
杨晓军	M
袁兵兵	F
沈鑫婷	F
王亚如	F
顾爱兄	F
王赛禹	M
岑幸子	F
高响梅	F
秦亚康	M
傅玲媚	F
包宁	M
周燕文	M
刘锋	M
臧倩	F
侯博	M
胡帅	M
曹云波	M
梅海平	M
熊焕顺	M
范雍	F
陈立	M
徐龙	M
杨勤生	M
余飞	M
陈庆肖	M
龙明艳	F
吴喜志	M
陈小楠	M
周玉杰	F
崔明峰	M
陈平	M
董吉辉	M
向瑞	M
李雪	M
董震	M
涂序万	M
郎恩	F
石璐	M
周文强	M
张拯	M
陈会军	M
张敏丽	F
何林	M
张永豹	M
张磊	M
敬文龙	M
刘宇	M
刘凡	M
叶海花	F
朱顺智	M
王路路	F
张玉姗	F
林盖	M
徐警	M
高秀莉	F
陶黄华	M
闵亮	M
李丽红	F
钟祥玲	F
刘佳	F
李晴晴	F
李欠欠	F
尹豪豪	M
梅肇兵	M
尹朝轮	M
李秀娥	F
卢军	M
熊华祥	M
杨晓红	F
周铭	M
雷圣晖	M
沈园萍	F
于江英	F
刘小慧	F
李颖	F
徐世飞	M
廖维兵	M
黄春英	F
罗亮情	F
刘树起	M
王学成	M
潘祺	M
徐云云	F
陶玉	F
谭外得	M
付守雯	F
陈宏新	M
夏伟	M
朱雪振	M
傅荣	M
袁琦	F
王林杰	M
黄康	M
王士奇	M
滕云霞	F
公亚南	F
贾云龙	M
陈德海	M
王新东	M
蔡芳芳	F
龚斯敏	F
刘佳欣	F
魏建	M
耿祥凯	M
刘曼曼	F
黄雪艳	F
李强	M
吴府成	M
张奎利	F
胡文利	F
钟开慧	F
杜长胜	M
廖伟琪	M
周骏马	M
周怿雷	M
陈琪	F
沈汉忠	M
叶林	M
张永红	M
王金臣	M
李宁	M
金浩	M
陶帅	M
叶琎宇	M
卢国旗	M
李明坤	M
董宣	M
胡伟	M
董维维	F
刘影	F
耿彬彬	M
何胜权	M
傅云娜	F
杜明强	M
沈凯祺	M
张旋	M
姚卫东	M
郭盼	M
琚志茜	F
李伟伟	M
章佳	F
周世荣	M
周涯宸	M
黄争贝	F
李静2	F
梁广胜	M
刘玲平	F
李玉堂	M
翟雨薇	F
戴志兰	F
孙高松	M
张品强	M
董芳斌	M
周红德	M
董丽桦	F
张俊杰	F
丁峰	M
张慧丽	F
刘晓光	M
曹元元	M
邓金燕	F
许佳豪	M
陈圳	M
杨彩云	F
刘立群	F
先小慧	F
沈仁裕	M
戎旭	M
瞿桂娟	F
吴鑫慧	F
张欢乐	M
马佳成	M
凌波	M
夏勤俭	M
杨乐	M
张涛	M
邓显强	M
周骞	F
黄炎	F
鲁述良	M
方霏	F
廖本群	F
苏义	M
余成来	M
赵德根	M
王俭	M
李红丽	F
张大丽	F
梁建英	F
吴军锋	M
徐敏敏	F
陆芳琳	F
刘泽生	M
顾瑶佳	F
赵文安	M
熊苏平	F
蒋春阁	F
张金伟	M
吴宝红	M
张哲	M
马雪井	F
程淑芳	F
涂桂琴	F
杜康	M
郭鹏	M
向新鹏	M
唐辉	M
罗保华	M
丁鑫鑫	M
张夏雨	M
魏建红	F
曾廷双	F
龚成	M
念田英	F
陈启龙	M
伍永华	M
王泽民	M
陈鑫斌	M
王波	M
关旭光	M
关振拨	M
杨亚光	M
张金凤	F
朱佳倩	F
范云娇	F
唐伟	M
谢才祥	M
张秋玉	F
王先兵	M
张震	M
赵明强	M
韩少聪	M
张鹏	M
谭红梅	F
杨修烈	M
马立忠	M
肖领	M
赵文晖	F
卢会莲	F
林小军	M
程寿景	M
赵丹	M
张凯	M
谭云爱	M
李小兵	M
向磊	M
马永仙	F
魏晓云	M
黄映芳	F
卢庆江	M
苏静	F
史爱国	M
魏建伟	M
周鲁杰	M
邵广胜	M
周春凤	F
徐涛	M
徐光锋	M
方丽勤	F
李英	F
梁海燕	F
王新朋	M
邱红梅	F
周荣爱	F
夏亮英	F
张世启	M
陈能杰	M
路盛兴	M
刘东红	F
刘艳	F
梁永宣	F
黎泽华	M
鹿剑	M
江莉	F
梁少秋	M
吴复员	M
王军明	M
谭笑	M
张坤娃	M
武强	M
武雪花	F
陈宝香	F
刘洋	M
濮伟	M
郭洪超	M
苏婷	F
张学辉	F
李红蕾	M
崔子俊	M
羊玉朋	M
俞瑞虬	M
孙首建	M
胡国其	M
谢振飞	M
周威	M
陈新景	M
熊志聪	M
张兵亮	M
于冬琴	F
金其义	M
陈义	M
邹婷	F
付鹏飞	M
游雪瑶	F
王成	M
马国才	M
朱秀萍	F
涂利明	F
杜喜朋	M
张景	F
程应滨	M
向中和	M
赵国松	M
吴乐辉	M
陶银	M
邹简	F
张建刚	M
陶仕祥	M
张志峰	M
程帆	M
聂张飞	M
林蒙蒙	F
张丽晶	F
李亚欢	M
杜建	M
高金红	F
谢冬生	M
陈福建	M
王春枚	F
黄俊涛	M
郝方胜	M
刘静	F
陈奇	F
马平君	M
范馨云	F
励文荣	M
吕安娟	F
孙建花	F
李海军	M
熊尚斌	M
唐茂林	M
郑剑	M
闫吉鹏	M
田玉军	M
张素丽	F
李智娟	F
胡思敏	F
林保龙	M
黄义超	F
仇晓梅	F
王磊	M
孙建平	M
付青松	M
庄芳芳	F
沈淇滨	M
刘艳华	F
盛海深	M
吴晓华	F
杨宏	M
彭彪	M
朱鹏	M
邵光敬	M
汤军	M
刘陈陈	M
陈春霞	F
赵洪昌	M
李沐阳	F
赵嘉宁	F
金雯铖	F
任琏宇	M
陈学芳	M
李小艳	F
曹灵霞	F
赵海军	M
陈雅	F
陈倩	F
钟长胜	M
厉军	M
许绍民	M
庄玲瑜	F
曾国华	M
邬定峰	M
谢晓琴	F
杨文学	M
王淑峰	M
施晓传	M
郭泰兴	M
羿超	M
熊有水	M
蔡健艳	F
吴晓凤	F
朱雄木	M
潘籽仲	M
刘丹丹	M
尚义皓	M
李颖雯	F
钱斌	M
张晓凯	M
苏丹	F
李志	M
杨康	M
吕运淮	M
沈汝山	M
刘翠	F
刘可江	M
韦德钱	M
杨玉华	F
王佳	F
赵庆庆	F
王文卓	M
曹英	F
高赛虎	M
谷元平	M
赵梦雪	F
崔华良	M
张灯	F
蒋璐宁	F
曹春	M
张再君	F
娄攀晓	M
崔利亚	F
廖小东	M
李红莉	F
马志伟	M
褚金星	M
罗耀军	M
栾江超	M
孙阳	M
王迪	M
杨艳敏	F
叶凯磊	M
张秋秋	F
徐祖成	M
吴祥东	M
祝小林	F
吴神林	M
汪尔泰	M
钟雪梅	F
彭海英	F
周扬	M
赵俊凯	M
杨启龙	M
李大毛	M
陈姣娥	F
吴荣军	M
高文娜	F
马应良	M
张跃	M
李金玲	F
汪文亚	M
李欣欣	F
付振超	F
冷戊云	F
罗帅	M
朱丙旭	M
陈圆生	M
薛赛赛	F
沈高萍	F
黄顺双	M
冯瑞瑞	F
黄添	M
李小闰	M
陈中培	M
陈光瑞	M
刘允见	M
张瑞	M
方健	M
綦强	M
王强	M
宋正梅	F
何文贵	M
张志峰	M
张朝辉	M
刘洋洋	M
杨勇	F
刘岩	M
胡定梅	F
陶少青	M
李杰	M
鲁婉君	F
夏兵武	M
刘大鹏	M
谢红果	M
周淑红	M
蒋雨平	F
张欣	M
韩松华	F
张谋华	M
王正糠	M
罗健	M
王春梅	F
郑晓明	M
冯宗业	M
鲁骏飞	M
张贵兰	F
叶梦蛟	M
邰佳佳	M
张方友	M
肖红英	F
任发明	M
陈俊超	M
王倩	F
张小会	F
田立心	M
郭凤兰	F
官阳明	M
孙进杰	M
徐雷	M
方会	F
冯慧	F
谢晶晶	F
齐忠霄	M
李文凯	M
龚旭锋	M
候艳	F
徐笑笑	F
罗敏	F
胡荣	M
李万前	M
王锋	M
何帅	M
张海东	M
杨晓琴	F
程昌麟	M
马祥云	M
熊云云	F
何钰	F
曾欣	F
唐福银	M
夏兵开	M
侯飞燕	F
方帮银	M
陈羿吾	M
王慧敏	M
倪德茂	M
李翔宇	M
代家慧	F
范存全	M
张强	M
张龙飞	M
张广顺	M
王成银	M
钱靖	M
张孟涛	M
肖小群	F
完颜磊	M
刘海州	M
高慧敏	F
邓赛峰	M
童自华	M
康中富	M
袁超群	M
陈豪	F
王燕仙	F
宣超	M
刘昕	M
郭欢欢	M
管倩倩	F
刘月丽	F
张瑞瑞	F
郭玉芳	F
苏得虎	M
陈远辉	M
邱小艳	F
高瞻	F
童婷钰	F
张红	F
全永芳	F
吴建龙	M
吴运红	F
余益	M
陶绪坤	M
游斌	M
周思爱	F
唐睿	F
刘矜言	F
徐得力	M
于婷婷	F
朱梦笛	F
周雄峰	M
付芷颖	F
刘强	M
万程	M
戴浩明	M
姜美玲	F
陈健	M
邹丹丹	F
张志勇	M
钟艳芳	F
方萍	F
沙婷婷	F
贺利君	F
彭贵英	F
陈晨阳	M
黄妮	F
刘峰	M
但益华	M
何梦霞	F
俞祖芳	M
孙程贤	M
卢国军	M
段全勇	M
温圆霞	F
陈晨	F
马征	M
马有橙	M
程相欣	M
陈体宁	M
韦冉	F
王荣兵	M
李雁娟	F
李毅	M
黄淑栏	F
江飞	M
孟杭秀	F
解雅静	F
黄甜甜	F
伍红	F
郭顺康	M
杨悦	F
王登辉	M
严红华	F
张庆峰	M
刘孟灵	M
蒋健	M
董秋金	F
伍德莉	F
周兴伦	M
盛强	M
朱碧华	F
刘禹文	M
林玉婷	F
陈李中	M
周标胜	M
朱勇	M
杨秀清	F
蔡小栋	M
吴鸣军	M
邢凡敏	F
陈凤鸣	F
闫雪飞	M
叶小雅	F
刘奥猛	M
包尚仪	F
付浩然	M
曹小根	M
李小老	M
陈维	M
娄银阁	F
王娜	F
吴双	M
周冕	M
商贝贝	F
毛振宇	M
王东园	M
叶圣舟	M
马殿辉	M
唐正武	M
汤艳平	F
陈学英	F
柯得军	M
郑高伟	M
鲁雯欣	F
张思卿	M
杨恩波	M
金兴国	M
高彬鸿	M
王文霞	F
倪凯妮	F
董蕾	F
胡雪胜	M
包婷	F
王磊	M
刘标	M
王亮	M
裘俊杰	M
高鹏强	M
倪海金	M
刘娜娜	F
汪雪	F
任明创	M
赖东锋	M
闫排超	M
曲树远	M
余彩义	F
徐诺骞	F
占聪华	M
范程俊	M
王杰	M
周静	M
王方方	F
马奴海	M
郭亚彬	M
唐美娟	F
孙迅飞	M
柴全喜	M
张朝龙	M
王航	F
郭勇平	M
宋建坡	M
吴华杰	M
黄琪洲	M
王冬冬	M
黄伟	M
石海娜	F
张建	M
陈方方	M
刘凯强	M
刘昂	M
吕小惠	F
马英	F
林芳	F
刘柏陶	M
李悦龙	M
金琳茜	F
雷丽丽	F
李禹诺	F
余翔翔	M
虞银军	M
梅凯	M
韩德伟	M
吴青	M
程严	M
谢阳炎	F
潘涛	M
杨杰	M
余霜	F
邹丽萍	F
潘安艳	F
方东磊	M
易玉春	F
杨允允	F
董富特	M
谢彪强	M
周志杨	M
李贺新	M
方维菊	F
李建玲	F
肖一	F
李波	M
杨必贵	M
谭渝川	M
杜观青	F
王婉琴	F
毕家兵	M
侯振林	M
罗梦婷	F
熊金标	M
赵含含	F
许昊臣	M
王鹏起	M
王红波	M
汪洋	M
屠璐琼	F
田院超	M
李晨霞	F
谢卿	F
唐辉辉	M
孙博闻	M
宋彦飞	F
宋斌	M
青秀林	M
牛文举	M
李启信	M
王颖	F
李倩文	F
李杰	M
李朝	M
马小燕	F
沈少明	M
吴寿飞	M
吉金浩	M
曾媛	F
瞿芳敏	F
许周颖	F
彭国胜	M
黄婷	F
翟原新	M
郑子明	M
吕明宇	M
闫子天	M
云月龙	M
陈洁洁	F
倪建英	F
杨鹏	M
姜俊明	M
江仪慧	F
熊渭颖	F
张志宏	M
樊荣鑫	M
吴明西	M
胡志浩	M
洪红	F
贺佳伟	M
何磊	M
郭宝龙	M
黄大龙	M
詹华君	M
童天锋	M
吝宇	M
李海英	F
赵赛	M
顾琪	F
花而实	M
何旭宇	M
谭立军	M
张杰	M
吴兴华	M
陆海兰	F
葛蓝	M
杨安康	M
张成孝	M
冉准	M
杨金金	F
毛小童	M
吴阳红	M
林炙淳	F
苏忠辉	M
陈锦辉	M
徐兰兰	F
杨兴凤	F
蔡剑波	M
曹颖	F
李浩	M
戴瑞文	M
常丽丽	F
李师明	M
丁鑫	M
舒全禄	M
李洪芝	F
王成林	M
熊维维	M
李强	M
韩得鹏	M
荆娜	F
秦家晨	M
王智渊	M
王浩	M
刘晨	M
饶锐	M
赵霞	F
陈景阳	M
朱勇	M
薛勇涛	M
孙晓波	F
朱彰楷	M
杨磊	M
陈晓君	F
陈宝娟	F
苏昂	M
王露	F
蔡正干	M
徐大力	M
吴日清	M
杜书艳	F
张莎莎	F
喻晶	F
吴倩楠	F
张成宇	M
孟静静	F
朱军	M
林华平	F
刘凡珍	F
田悦	F
杨帅	M
吕佳玉吉	F
郭海平	M
王琴	F
尹小容	F
刘文博	M
林秋女	F
林朝辉	M
陈洪	M
杨倩倩	F
何海兰	F
侯静如	F
王正玉	M
齐羽龙	M
王晓凤	F
柏家莉	F
李佳佳	F
王琳	F
唐颖	F
俞国勤	M
张志飞	M
冯蓬	M
曹学敏	F
陈敏	F
郜建明	M
马靖雯	F
郭慧颖	F
曾东阳	M
张宁	M
徐伟	M
季义强	M
李翠玲	F
刘正如	F
王佳	F
马海洋	M
马建荣	M
汪俊峰	M
罗胜	M
周易	M
王晟	M
郑嘉欢	F
徐宁	F
徐杰	M
王强	M
赵琢雯	F
陈彦霖	F
徐雨东	M
刘浩凯	M
任骏	M
童群燕	F
董申华	M
陈梦	F
杨永芬	F
罗国州	M
王宇	M
王森	M
王瑞光	M
陈秀淋	F
彭芳杰	M
陈星星	F
张勤	M
陈银儿	F
厉晶晶	F
宋志函	M
严尚源	M
吴海姣	F
李争	M
毕树波	M
张伟晖	M
张杰	F
袁宝	M
杨文君	F
杨东林	M
杨道明	M
李传宠	M
念鑫	M
俞锡江	M
崔艳军	M
刘玉静	F
王晨慧	F
潘清超	M
熊绍春	M
王棋	M
万启文	M
陈伟	M
林雄财	M
谢京甫	M
陈鹏	M
叶锦	M
吴艳秋	F
涂志强	M
张发坤	M
龙群英	F
徐光亮	M
黄喻	F
王雅莹	F
陆佳妮	F
孙敏慧	F
向井胜久	M
王卫清	F
龙德斌	M
陈尚鹏	M
陈建	M
段玲	F
杨彬	M
阳紫娟	F
薛松焘	M
徐志敏	M
王彦春	F
孔金平	F
周丽平	F
赵友强	M
高婷	F
刘瑶	M
胡伟健	M
叶桑桑	F
宋啸笑	F
唐术辉	F
徐玉武	M
陶古乐	M
邢斌	M
翟伟罗	F
赵莹梦	F
周颖维	F
熊建强	M
吴学艳	F
冯迎杰	M
游夏景	F
王再国	M
吕巧园	F
黄恒	M
任新科	M
徐岩	F
屠家伟	M
柯淑芬	F
李丹丹	F
张豪	M
李晓怡	F
芮兵	M
刘真华	F
张热	M
徐昌俊	M
王惠	F
张献徽	M
钱梅飞	F
方樱琴	F
姜乾麒	M
尤江林	M
张彦龙	M
张明霞	F
周成良	M
吴莹	F
肖宏利	M
武霄	F
吴琼	F
向春艳	F
石颖	F
张幼娜	F
周博	M
袁建文	F
毛灵	F
李岩	M
郭陈琴	F
梁志国	M
赖鑫	F
李威	M
王勤娟	F
洪波	M
周玉杰	F
杨帆	M
吴明	M
李淑芹	F
张韬	F
何林	M
涂永智	M
李汶衡	M
蒋密密	F
任志红	F
徐雅洁	F
胡河涛	M
张全	M
杨坤阳	M
夏笑丽	F
姜亚洲	F
韩刘恒	M
丁喜洋	F
吴庚谢	F
王丹	F
叶定国	M
徐晓桐	F
吴晶	M
杨志强	M
金苏贺	M
刘金山	M
曹建群	M
刘青岭	M
许李文	M
陈浩阳	M
陈辉	M
闵定智	M
马舒婷	F
胡帆	M
李婷	F
岳云飞	M
卢灿宇	M
朱振华	M
颉仁强	M
张占军	M
戎明	M
任德伟	M
李利云	M
张月桂	M
张小马	M
李团结	M
周记	M
汤万超	M
伍海琴	F
赵丽丽	F
罗凯	M
尚飞	M
钱传龙	M
周雪梅	F
丁浩	M
陈诚波	M
秦家文	M
付云菊	F
刘江锋	M
褚昌盛	M
周晶晶	F
张志超	M
叶晶晶	F
沈旭	M
王长征	M
程然	M
叶玲	F
水恒雷	M
蔡盛建	M
马康	M
吴婷霞	F
李小虎	M
单晓丹	F
黄名祥	M
李峥	M
谢安翰	M
倪杰	M
尹祖清	M
胡刚	M
倪亮	M
林明明	M
张飞	M
周文强	M
廖佳威	M
吴君宇	M
徐辉	M
胡滟冰	F
杨红	F
藏地正夫	M
王梦诗	F
严年	M
敬亭书	M
倪敏	M
叶飘	M
许延彭	M
徐向东	M
史锦杰	M
石晟辉	M
王静	F
赵飞	M
谭璐璐	F
黄智力	M
张超	M
秦诗硕	M
沈新鑫	M
邓武	M
吴兴明	M
付雷	M
王缔	F
周照红	M
郝涛	M
郑小蓉	F
罗丽彩	F
张祥金	M
黄蕾	M
张慧	M
尹向明	M
陈君杰	M
王白克勒	M
虎学鹏	M
姬成伟	M
曾义强	M
年云娟	F
范超	M
杨洪爱	M
林员	F
钟佳莉	F
宁果豪	M
代美均	M
赵虎	M
曹端铭	M
崔红丽	F
刘佛洪	M
欧阳冰洁	F
陈龙	M
何锡波	M
袁长杰	M
杨荣	F
王成龙	M
周露	F
张志丽	F
杨先富	M
陈东旭	M
刘强	M
林聪聪	M
刘嘉玲	F
赵涛	M
张文彬	M
余同星	M
孙远征	M
郭永亮	M
程林科	M
林鸿达	M
张金涛	M
徐强	M
乔杰	M
陈琴	F
周菲	F
楼树林	M
林伟	M
李开慧	F
王笑歌	F
方宇	M
曹庆丰	M
王淑敏	F
骆文祥	M
张旭方	M
吴丰旺	M
张天成	M
裘静妍	F
刘鹤	F
陈若君	F
彭芳	F
闫国庆	M
杨莹	F
刘玉梅	F
刘诚	M
李蓉蓉	F
王俊杰	M
白二	M
舒畅	M
孟宋伟	M
刘小欣	M
姜伟	M
王影	F
陈金华	F
马秀芳	F
杨先红	F
木田琢己	F
霍振煜	M
朱劲华	M
熊陵平	M
唐晓菲	F
曾令萍	F
李冰冰	M
周灵	F
刘小培	F
左姣姣	F
刘俊远	M
陈宏杰	F
孟涛	M
王文轩	M
崔学君	F
覃芸	F
刘海成	M
李明	M
谢振丽	F
蒋晨	F
虎有素	M
王伟举	M
兰风荣	M
薛志刚	M
付海颖	F
罗拴学	M
张立冉	M
廖鸿伟	M
庄东东	M
吉塚信一	M
沈孟奕	F
张迥异	F
曾超清	M
金涛	M
李淑婷	F
唐理耐	M
瞿盛伟	M
梁美珍	F
魏雅琼	F
张辉	M
吴永强	M
金苏美	F
夏元娜	F
王雅倩	F
张猛	M
刘万理	M
田铃	F
陈慧炜	M
朱林威	M
胡飞	M
麻淑剑	F
彭聿敏	F
王虹	F
华逸航	M
田招文	M
刘保兴	M
梁敏	F
孙坤	M
张元顺	M
吴志顺	M
周洁	F
肖丽萍	F
郑若妍	F
陈萌	F
范青青	F
陈惠	F
庞明欢	M
张超	M
凌宗芳	F
邵桥	M
陈许嘉	M
陈榕坤	F
江维	M
宗发土麦	F
马雯	F
张荣娟	F
杨桂金	F
闫丽娟	F
彭晓霞	F
吴梦婷	F
方舟	M
杨晨	M
马祖比代	F
蒲志胜	M
张雅超	M
赵紫玉	F
杨凤山	M
刘斌	M
魏连生	M
李静义	M
胡东	M
张连宇	M
吴能港	M
李欣成	M
李文芹	F
王小雷	F
沈海军	M
陈震	M
杨焱	M
韩志刚	M
宁利峰	M
武秋花	F
吴晶鸽	F
陈庆平	M
褚一霞	F
罗瑞勇	M
杨茂仙	F
肖罗英	F
赵艺功	M
施传峰	M
郑晓钰	F
钱莹莹	F
周志林	M
田观超	M
李明亮	M
潘铁波	M
郭懿远	M
杨红	F
洪法	M
方丹	F
张东启	M
刘斯琪	F
胡光	M
阴海燕	F
刘楠楠	F
刘波	M
张彦博	M
张连鑫	M
印泽南	M
杨娇娇	F
应巧	F
冯程	M
沈学良	M
俞亿邦	M
陈金露	F
张亚丽	F
朱富豪	M
陆定州	F
周俊杰	M
肖平	F
李伟丽	F
万和香	F
黄怡然	F
杨立娜	F
陈光友	M
杨沈佳	F
段伟朝	M
康洁	F
赵洪斌	M
李俊	M
张新顺	M
江华	M
朱高稳	M
张少杰	M
王久平	M
顾雅莉	F
周昕斌	M
余静	F
苏曼	F
钱晨红	F
朱雨蒙	M
董越	M
李想	M
孙瑞松	M
周伟杰	M
牛燃恒	M
夏科尧	M
金贵银	F
宋昌永	M
蒋志雷	M
彭青婷	F
熊招弟	F
王佳英	F
后乐乐	F
冯丽娟	F
刘香敏	F
刘恒源	M
姜朕	F
何倩	F
陈亮	M
钟玉琴	F
顾文俊	M
赵益	F
贺鹏帆	M
夏晓航	M
王宁	F
蔡振华	M
袁伟	M
郭莉莉	F
欧阳烈肖	F
许英群	F
陈云	F
钱凯	M
颜青娜	F
强益铭	M
张娜	F
戴锡柱	M
王敏燕	F
钟祖超	F
闻铭宇	M
宋辉明	M
刘卫	F
彭飞	M
庞孝颖	M
董自如	F
林姝均	F
张雪亮	M
徐惠	F
夏伟	M
刘涛	M
吴学峰	M
宋元坤	M
王梅华	F
郭建麟	M
周益	M
段康林	M
王帅帅	M
李培亮	M
罗自超	M
张强	M
包甲强	M
于波	M
艾衡	M
朱慕刚	M
明星	M
生进兄	F
舒泱聪	F
张敏	F
袁全国	M
邹富强	M
张换	M
闫凤凤	F
王振华	M
王千广	M
王静	F
岑佳楠	F
俞星	M
李子健	M
韩家宇	M
杨素真	F
王强	M
姜婷	F
武梦瑶	F
罗群	F
白洁	F
孙军杰	M
陈春娜	F
董小兵	M
张睿妍	F
李智	M
颜如斌	M
徐秉楠	M
葛振伟	M
朱建娥	F
胡鹏宇	M
周强	M
张明明	M
韩军	M
彭继林	M
王芳	F
冯姣	F
张陈青	M
楼凯琪	M
王荣华	M
王川	M
张旋	F
吴煜锡	M
潘昊	M
曾强	M
李亭亭	M
谢阳	F
刘兵武	M
李后连	M
韩啸天	M
段文存	F
袁一鸣	M
段江江	M
王相如	M
胡雪琼	F
柯露露	F
郭玉帆	M
谢君君	F
王巧濛	F
方雨蓉	F
陈辉	M
沈宇虹	M
卢春燕	F
彭聪	M
罗俊宇	M
吴杰	M
汪力	M
张美扬	M
周鸯	F
李敬文	F
林坡	M
付旺	M
张辉	M
辛小燕	F
尚富美	F
付朝强	M
陈瑶芳	F
吴秋华	F
王武	M
胡芯僮	M
张丽波	M
涂金铭	M
卜荣伟	M
熊杰	M
陈华	F
王中平	M
麻麦丽言	F
肖水平	M
陈小燕	F
罗美娥	F
孙碧徽	M
陈佳燕	F
郑国会	F
许倩	F
杨圣威	M
张友	M
庞柳青	F
张樱	F
袁璐1	F
毛欣	F
郑慧青	F
王昆	M
刘卓	F
林芬芬	F
王新宇	M
刘坤	M
何田田	F
李超	M
王家乐	F
李梦思	F
陈思言	F
张小奇	M
杨昆	M
史春娟	F
李锡勤	F
秦漫漫	F
江莹	F
高鹏帅	M
秦艳秋	F
王胜	M
方一淋	F
赵红霞	F
刘艳	F
叶淑霞	F
陈国战	M
秦尧	M
靳训谦	M
彭晓露	F
牛天威	M
李会杰	F
曹先驸	M
李正龙	M
郑博文	M
张旺成	M
杜宏亮	M
张慧	F
刘英瑞	M
程润春	M
李显东	M
吴海波	M
史圣焘	M
杨莉莉	F
王艳琴	F
马云明	M
吴晗	F
林志伟	M
黄荣	M
涂会玲	F
杨璐	F
甘宏伟	M
叶芝琴	F
陈艺	F
张云霄	F
刘文亮	M
杨欢	M
张龙	M
柯李浩	M
刘玲芳	F
孙猛思	F
魏众	F
陈敏	F
陈国珍	F
辛盈盈	F
吕梦雅	F
陆剑鹏	M
季路	M
赵岩	M
朱立波	M
刘樊	M
兰德明	M
沈烨霞	F
刘明明	F
王杰	M
吴鹏	M
金欣	F
黄雨涛	M
马雪青	F
蔡宇栋	M
裴高博	M
文贇	M
陈群	M
刘瑶	F
秦明军	M
朱建容	F
沈鑫	M
裘玉波	F
李福斌	M
郝景余	F
黄娅丽	F
李晓阳	M
许浩	M
鲁露露	F
陈晨	F
庄敏珉	F
谢秦	F
谢舒婷	F
吴小燕	F
苏尹	M
王帅旗	M
汪紫成	M
李宗蕃	M
李家勇	M
龚彦斌	M
张鑫宇	M
邓悄	M
张坤萍	F
李芸芸	F
刘晓艳	F
王联凤	F
曹玉楠	F
孙家东	M
李嘉鑫	M
徐玉华	F
罗建冰	M
黄强	M
田进飞	M
李笑笑	M
谷亚芳	F
郭永基	M
阳忠忠	M
罗燕兰	F
何绍迁	M
朱忠稳	M
王玉洁	F
张垿	M
彭明华	M
韩笑	M
孙任格	M
张涛	M
何中海	M
马己不拉	M
洪珊	F
李启佳	M
张杰	M
张继舟	M
李鹏飞	M
张书根	M
程晓虹	F
周兆美	F
刘洪雨	M
王景凯	M
文善腾	M
罗国平	M
马金健	M
方文琴	F
张艳群	M
余小兵	M
赵家爽	M
曹燕兰	F
马苗苗	F
张艳	F
蔡小颖	F
王霞	F
袁明华	M
严炜杰	M
邹平涛	M
宫庆	M
陆嘉伟	M
张倩男	M
马海虎	M
马海英	M
马云江	F
马海波	M
孟春婕	F
聂南南	F
李朋文	M
吴昊	M
闫聪	M
吴淑花	F
吴玉梅	F
卢伟明	M
滕龙	M
邓奇贻	M
张华	F
卢溢之	M
沈燕	F
王飞	M
赵蔚	F
丁雨	M
单剑波	M
昝佑民	M
程晨	F
李强	M
陈永曾	M
陈飞	M
汤乃生	M
许凌哲	M
丛瑛	F
胡瀚	M
郭健	M
汪桃青	F
徐垠垠	F
周杰	M
骆丹	F
张腾	M
冯佳美	F
苗恩武	M
金齐鹏	M
陈兴	F
冯嘉宇	M
肖莉	F
张琦	M
金傲雪	F
雷意修	M
唐寅生	M
罗志宏	M
李校强	M
黎景宇	M
何琪君	M
沈艳	F
方剑	M
杨太祥	M
胡静静	F
刘炳宇	M
刘君文	M
颜建萍	F
邓茂新	M
薛松	M
侯海霞	F
王利飞	F
虞周唯	F
仇定超	M
张嘉诚	M
姚永建	M
彭小燕	F
郑杏连	M
张香瑞	M
邵亚萍	F
刘攀	M
隋德春	M
董冰冰	F
唐艳	F
贾正迪	M
郑旭	M
唐健	M
马贤尧	M
沈达	M
张英英	F
秦敏	M
刘晶晶	F
韦小安	F
舒婷丽	F
孙金宏	F
王武定	M
左荣林	F
吴翠伍	F
黄雨欢	M
林坚生	M
王映雪	F
王伟	M
夏小红	F
毛柯云	F
李峰	M
陈健明	M
段祥和	M
孙晓艳	F
俞帆	M
丁阳	M
宫马保明	M
齐中正	M
姜三波	M
王玉红	F
王飞	M
陈丹健	M
陈祖鹏	M
马花	F
吴博	M
徐张	M
沙皓	M
刘家宽	M
葛冬英	F
朱文康	M
罗嗣文	M
邱少霜	M
冒洁	F
胡志强	M
张洛源	M
陈姣	F
徐丹	F
高森洪	M
胡灵芝	F
樊周龙	M
郝伟	M
潘永平	M
尤春景	M
盛康	M
陈君	M
沈洁	F
周丁美	F
陶永德	M
施正强	M
曾蓉	F
马六十一	M
马西拉支	M
汪腾	F
薛鹏程	M
徐文伟	M
饶敏	F
潘旭东	M
张文举	M
李兰芳	F
朱雪琪	F
魏金花	F
张心怡	F
饶嘉伟	F
邢光勇	M
张欣	M
盘晓智	M
马麦来也	F
贾优	M
潘梦婷	F
张琼	F
李小冬	M
禹志超	M
李福辰	M
张红梅	F
马全海	M
马关亮	M
张冲	M
孙志佳	M
熊绍俊	M
熊志详	M
喜彦财	M
门丹丹	F
马海祥	M
张艳玲	F
韩永新	M
张珍	F
李乖林	M
袁观秀	F
夏永毅	F
杨海明	M
周慧	F
吕浩	M
李志衡	M
鄢治华	M
屈震娟	F
张英参	F
袁巧霞	F
宋宇宁	M
任天彬	M
石文雅	F
张红彬	M
马群兰	F
张沙沙	M
朱科南	M
沈仁元	M
陈么麦德	M
吕文婧	F
张明洋	M
李燕玲	F
苟学历	M
肖祖锦	M
李庆功	M
周健	M
张红霞	F
孙良福	M
刘虎	M
王基强	M
余慧彪	M
葛广营	M
朱乾凯	M
汪静	F
陈萍娜	F
苏飞龙	M
坂口正	M
仲仓良雄	M
张建鹏	M
时杰	M
裴玉虎	M
徐英	F
冯闯	M
万子龙	M
李良	F
王顺林	M
胡水莲	F
赵志健	M
杨德超	M
王平	M
江昆阳	F
邱明勇	M
谢国勇	M
徐瑞	M
张晓庆	F
王涛	M
谢豪	M
朱进进	M
王培松	M
张佳怡	F
周静	F
翟耀文	M
丁盼	F
渠爱玲	F
王群力	M
钱祺	M
马浩浩	M
张家成	M
徐园	M
杨媖	F
王凯	M
张伟	M
周彩梅	F
王园园	F
王倩	F
彭传松	M
张浩	M
曹秋霞	F
杨聪	M
田茜	F
张微威	M
韩世花	F
林英志	M
程启华	F
方梦佳	F
陶国涛	M
曹光保	M
孙攀飞	M
徐平	M
韩亮	M
刘俊杰	M
居翔翔	M
孙彦利	F
颜铁牛	M
吴成喜	M
段普恒	M
黄政伟	M
熊火紫	F
徐代武	M
韩二力	M
韩有梅	F
王品纲	M
黄颖琪	F
潘七呷	M
陈立波	M
宋立遵	M
方飞	M
徐观祥	M
邱悦	F
左菁	F
王鹏	M
田鑫	F
赵艳林	F
阮仙仙	F
金涛	M
龙兴华	M
戴国伟	M
王娟	F
杨雨薇	F
陈鑫浩	M
王慧	F
李小洁	F
杨旭锋	M
孙冰洋	M
陈家鹏	M
许琴	F
汪旭琼	F
胡志亮	M
张建刚	M
金凯	M
黄海悦	F
叶昌容	F
任雅聪	F
陈林辉	M
肖伟	M
陶均匀	M
邹俊	M
汪勇	M
汪雅菊	F
易元礼	M
熊龙华	F
陆娟银	F
毛盈盈	F
郭成	M
郝乾乾	M
赵德利	M
周保军	M
丁思琪	F
郑后成	M
杨洋	F
葛素芬	F
李金梅	F
李展疆	M
任晓斌	M
刘炳森	M
王毛毛	M
陈凯	M
郭娇	F
张登	M
熊时强	M
谢宇霏	M
徐振宁	M
吴龙清	M
任姗姗	F
陶涛	M
鲁基冬	M
曹中科	M
郝娇娇	F
刘俊森	M
薛娜	F
戴婷婷	F
柳露露	M
徐金果	M
王东洋	M
桑盼盼	M
黄福利	M
吴波	M
陆梅军	M
崔小琴	F
马桂兰	F
贾万春	M
周思博	M
付葆迩	F
姚伟芳	M
吴平	F
陈后良	M
刘峰	M
符淑燕	F
王志霞	F
杨新爱	F
韩世琴	F
文凯	M
赵勇勇	M
颜小芬	F
班一帆	M
饶文强	M
邹园园	F
汤青青	F
罗文醉	M
丁联庆	M
程慧	F
罗会国	M
邢玉镜	F
洪于婷	F
马雪梅	F
顾秀能	M
俞佳红	F
罗治坤	M
罗希洋	M
李玉红	F
刘世平	M
庞新莲	F
高永付	M
林清清	F
张佩佩	F
邵增强	M
汤梦婷	F
任利钦	M
韩锁	M
陈巧文	F
王志文	M
杨新余	M
杨文秋	M
张泽	M
苟学熬	M
兰湖平	M
陈美娟	F
胡小平	M
凌贤明	M
张安	M
陶侕圣	M
陈健	M
马国祥	M
邓杨英	F
邹小媛	F
马金莲	F
中村顺司	F
姚洁	F
逄浩	M
张如	F
魏祥通	M
张顺	M
焦朝勋	M
刘允雷	M
张看看	M
李立国	M
何蒙	F
邓海洋	M
包冰烨	F
熊学波	M
李建英	F
柴烨鑫	M
赵来明	M
顿永林	F
卜伟芸	F
薛慧娟	F
周振威	M
王学武	M
王阳	M
陈波	M
杨风云	F
叶军	M
李娜	F
马慧茶	F
赵毅	M
朱圣江	M
郑媛媛	F
罗美琴	F
张风贤	F
阚莹莹	F
王云华	M
谭倩	F
李艳梅	F
姜雅腾	M
魏令武	M
张辉波	M
欧倩宇	F
姚翔	M
牛领群	M
熊桂芳	F
冷金玉	M
闵燕春	F
蔺韦韦	M
王珍珍	F
郭正连	F
周勇	M
陶德明	M
田闽章	M
王红	F
启东生	M
王晓东	M
朱利娜	F
黄园园	F
杨旭灿	M
杨雪	F
李佳伟	M
方舟	M
王奇	M
李茹	F
黄庆芳	F
刘子强	M
吴亚鹏	M
方卫赤	M
陈琴	F
王前进	M
余平	M
张育燕	M
王棒棒	M
何琦	M
路乃柱	M
钟艳娟	F
刘思琦	F
高宏	M
张亚冰	F
赵风	M
王金凤	F
唐文文	F
刘秀兰	F
王忠克	F
彭虎博	M
廖文武	M
孙冬洋	F
陈金艳	F
徐勤红	F
吴烨楠	M
刘璐	F
邢蓓蓓	F
毛小敏	F
张继成	M
赵丽	F
屈红梅	F
吴冬梅	F
许赛	M
耿庆国	M
信提提	F
申艳梅	F
叶苗苗	F
唐兆云	M
李红彬	M
赵洪利	M
陈高民	M
潘发超	M
毛旭科	M
李浩	M
杨姿	F
林余敏	F
孙文霜	F
郭政言	M
郑浩南	M
郭文松	M
任立森	M
胡宇峰	M
彭龙波	M
吴苏芝	F
李权	M
吴丽芳	F
雷亮	M
曾令培	M
胡明荣	M
谭钦燕	F
张仰填	M
董小琛	M
彭玉琴	F
周发清	M
周斌	M
周亚非	M
谭丽丽	F
魏淼	M
宁凯	M
高祥	M
刘彤	M
梁丰华	M
田越	F
肖思瑞	M
蔡金君	F
邹媛媛	F
陈勉	M
王静杰	M
王钰莹	F
周青山	M
徐汪敏	M
许荣耀	M
胡俊云	F
何道斌	M
王志林	M
张勇	M
周姿	F
陈演中	M
龚欢齐	M
叶子源	M
王东风	M
程俊兵	M
袁志坚	M
陈静	F
李瑛莹	F
汤超	M
张磊	M
单其文	M
彭青松	M
余继旭	F
李秉仑	M
干忠琪	M
徐桃	M
张培培	F
喻保珍	F
夏钱钱	M
吕吉发	M
陈菊	F
谢文美	F
李国琼	F
陈洋	M
刘海欧	M
高生	M
陈志锋	M
芦建懿	M
余振强	M
郦轶沁	F
赵开香	F
修雅娟	F
单成林	M
陈浩	M
杨禾	M
温绍平	M
陈培武	M
肖玲玲	F
杨云飞	M
王秋艳	F
徐超	M
陈红斌	M
李海清	M
胡金兰	F
高永刚	M
王丽丽	F
张骞	M
皮嘉武	M
马其佳	M
胡国凤	F
李连松	M
谷代松	M
樊旭	M
耿娜	F
陈萍	F
郑淑萍	F
孙文辉	M
颜佳莹	F
刘群	F
万和英	F
熊菊云	F
吉纳尔古	F
卢定坤	M
梁志材	M
栗海岭	F
李兴椒	M
张志斌	M
姜斌	M
罗湘飞	M
黄静思	F
陈兴容	M
涂继金	F
李丹杍	F
张茂丽	F
侯杰	M
张晓飞	M
楚志园	F
阳晓	F
赵飞	F
张宇	F
刘智阳	M
胡波	M
严真真	F
王玉新	F
肖军	M
周奔驰	M
文振计	F
郭兵	F
黄玲慧	F
陈益萍	F
赵友泉	M
范士亮	M
陈利	M
张聪敏	F
谢明胜	M
谢雪义	F
梁燕	F
曹晓晖	M
谭永好	M
李龙	M
刘素贞	F
秦园	F
彭元堂	M
朱祥凤	F
鲁金磊	M
龙福勇	M
张强	M
夏永强	M
李龙	M
夏仁杰	M
孙丽	F
孙秀英	F
李广军	M
范文科	M
徐玉超	M
黄朝杰	M
刘小尖	M
刘改红	F
汪如飞	F
胡春喜	M
厉桂玲	F
马永秀	F
伍鸿勋	M
张国霞	F
胡金风	F
黄欣余	F
符海波	M
王柳威	M
劳晶晶	F
段金龙	M
张冬爱	F
李瑞玲	F
罗海水	M
任立科	F
郑洋光	M
王春霞	F
邢鹏	M
陈里初	M
陈只地	F
王鑫涛	M
马晓艳	F
马福才	M
王文花	F
杨占虎	M
张文侠	M
陶玉华	F
张文鹏	M
孔德坤	M
王捷	F
王腾飞	M
方迅	M
金苏花	F
谢文进	M
金玉	F
卜宜元	F
白路庆	M
牛群	M
马吉龙	M
郑阿英社	F
王慧娜	F
周丽萍	F
何帅帅	M
丁文杰	F
江四梅	F
王月娟	F
张鹏飞	M
尚瑞同	M
李丹丹	M
魏红花	F
吴萱萱	F
秦强	M
姚伟	M
石清慧	M
刘娟	F
郭磊	M
王鑫	M
周鹿怡	F
严丽吉	F
章雅芬	F
程征	M
石影	F
陶宇	M
熊典琴	F
夏贤文	M
胡方明	M
储维	M
黄椿雁	F
郑雯雯	F
王家烔	M
孙世国	M
屠友灿	M
陈联娟	F
何鹏	M
黄正海	M
任月秀	F
郑春良	M
万利琴	F
叶鹏宇	M
杨海啸	M
孙莹	F
江玲	F
余付水	M
刘子文	M
孙欢	M
滕蓉	F
戴林铃	F
闫贺鹏	M
苏纬华	M
林丽娜	F
窦充	M
孟明	F
周月	F
刘程	M
陈少雄	M
崔兆金	M
王崇辉	M
马建法	M
申帅卿	M
于柳	F
杨传亮	M
贾金悦	F
刘梦缘	F
杨欣月	F
刘小芳	F
裘九曜	M
周苗苗	F
聂广耀	M
谢火光	M
谭玲玲	F
曾庆河	M
姚春兰	F
华龙海	M
李杭程	M
谢文强	M
杨洋	M
王佰权	M
袁凯	M
沈楚岚	F
赵悦	F
赵航彪	M
杜雨	M
秦海菊	F
阮征	M
李瑞林	M
姚兰	F
夏维倩	F
王超	M
宋晓庆	F
亓迎杰	F
汪卫平	M
钱瑾	F
周宽宽	M
张大海	M
俞文军	M
黄欣	F
张丽	F
马花	F
岑冬园	F
李强强	M
虞秋燕	F
李维双	M
曹佳燕	F
马文娟	F
刘先权	M
王代底	F
扈睿涵	M
李祥祥	M
李青松	M
王菊红	F
张梦曦	F
吴建珍	F
郑万虎	M
陈光	M
胡凯	M
林勇国	M
江思龙	M
肖辉	M
李尼娜	F
陈建敏	M
许海松	M
王敏	M
严亮亮	M
杨国强	M
郁成龙	M
罗运甜	F
王明凯	M
王影	F
陈醒	M
吕绍富	M
吴泉	M
谢永艳	F
喻亮亮	M
余美玲	F
海治明	M
宋强生	M
陈文兵	M
李莹	F
胡艳屏	F
马干超	M
钱宇	M
竺岚	F
胡前进	M
吴文才	M
姜亚坤	M
彭彬彬	M
项薇	F
于垚林	M
王志球	M
魏吉	M
鞠盈新	M
梁诀然	M
钱哲	F
陈检生	M
金军松	M
熊帅	M
张帅	M
代金梅	F
江凯	M
叶晨林	M
张王闯	M
齐浩楠	M
高博文	M
朱宏	F
李晓波	M
章科峰	M
姜平平	F
包阳洋	M
王莹莹	F
何庆玲	F
王新贺	M
王英达	M
刘展志	M
张维	F
潘网蒸	F
孙钰翔	M
王华	F
包治业	M
岳良永	M
付博	M
王静	M
黄伟	M
李跃家	M
吴伟	F
刘昭婉	F
王允	M
刘飞	M
邓盼	M
方晶	M
程嗣女	F
熊文文	F
王海霞	F
黄杨东	M
梁著红	F
汤文璐	F
马国成	M
马彩霞	F
段华丽	F
邓朋飞	M
薛瑞艳	F
陈望	M
宫超	M
董鑫	F
杨付军	M
杜珂	F
王佛田	M
朱珈铭	M
何延斌	M
辛书玲	F
褚志申	M
何君君	M
秦雨	M
王伟	M
胡舒冉	M
李志卿	M
靳高昂	M
赵会锋	M
王志园	M
冯润	F
王颖	F
樊亮	M
许健健	M
李威加	M
马木比奴	M
楚晨旭	M
程涛	M
杨争夺	M
张蒙召	M
王国强	M
余洪	F
许良才	M
张艺	M
彭兴俊	M
李大菊	F
张心乐	M
陈小龙	M
陈翔	M
陈丽娟	F
朱其涛	M
胡楼	M
黄文明	M
李利慧	F
寇晓庆	F
刘东阳	M
任震杰	M
王万军	M
向磊	M
彭丽文	F
柏彩珍	F
王燕	F
陶凯	M
赖芹芹	F
潘焱	M
陈杨	M
杨兵兵	M
徐磊磊	M
寿泠泠	F
郑锦航	M
陈志华	M
王艳青	F
李佳佳	M
杨奥	M
唐长恩	M
朱增福	M
马黑麦	M
马玉花	F
马宗宝	M
丘婷婷	F
黄浙英	F
张呈杰	M
邱克新	M
任添佑	M
拜艾布	M
王学强	M
刘建勋	M
王云鹤	M
魏加钢	M
李绍勋	M
胡静	F
何嘉曼	F
吴玉洁	F
杨瑞	M
俞静妙	F
邓友华	M
周雄	M
杨平	M
郭志强	M
林晨	F
戴恒燕	F
王京豪	M
魏华锋	M
夏银凤	F
单德亮	M
王伟	M
刘红涛	M
王竟龙	M
王凯帆	M
艾子然	M
张如亚	F
郭加玲	F
韩和平	M
邢振	M
舒秀秀	F
陈春燕2	F
张竹盛	M
胡桤	M
张明轩	M
罗爱莲	F
吴晶晶	F
陈莉	F
刘杰	M
陶婷婷	F
潘佳	F
王玮洪	F
王皓	M
贺世杰	M
苏杰	M
邓亚萍	F
徐文娟	F
应利江	M
邱勇	M
谢伟伟	M
刘红婧	F
夏丽娜	F
郝三星	M
吴立成	M
费玲玲	F
刘天慧	F
果冬炜	M
汪瑞霞	F
刘志伟	M
文四妹	F
金文涛	M
李皆云	M
沈宇超	M
曹勤	F
耿俊茹	F
尉巧迪	F
陈苏兰	F
郝浪浪	M
汪姗	F
金长伟	F
曾光鑫	M
孙鹏	M
徐艳娥	F
罗朝权	M
刘启辉	F
赵雪琴	F
杨南南	F
李云亮	M
雷少刚	M
金晓敏	F
刘亚倩	F
钱霖	F
张旭	M
廉婕	F
蒋建华	F
夏招英	F
申立琥	M
李明仁	M
顾明佳	M
杨路	M
徐辉娥	F
赵倩倩	F
颜清林	F
吴金玲	F
阮蕾	F
方行立	M
刘金城	M
杨若贤	M
石书豪	M
修远航	M
吴卫兵	M
陈均旗	M
包丽娇	F
袁虎林	M
黎志远	M
杜远梅	F
鲍欢欢	F
何金福	M
毛冬英	F
姚交峰	M
崔赛明	F
朱勤杰	M
闾德刚	M
魏双雨	F
谢发燕	F
吴丹	F
曾林波	M
纪学友	M
刘毛妮	F
陈苏爽	F
吴伦芳	M
何意芬	F
宁萍萍	F
陈海波	F
唐如芳	F
林行儿	F
王鑫	M
宋航航	M
鲁小贞	F
薛柏	F
罗明海	M
姚欢春	M
熊克文	M
严永辉	M
包娇娇	F
文银花	F
高殿喜	M
裘聪权	M
吴勤凤	F
吴丽郡	F
张德华	M
王海银	U
裴恒元	M
陈孝妃	F
吴磾	M
郑炜杰	M
李丽华	F
陈锋	M
高洪建	M
覃格	F
陈玉国	M
熊腊花	F
余洪顺	M
许晓宁	M
张世杰	M
方奇艳	F
喻罗琴	F
海成	M
冶哈三	M
王其南	M
陈滢钰	M
孙成龙	M
黄超	M
王旭光	M
许文涛	M
曹成林	M
陈静	F
章胜根	M
刘世豪	M
孙洪娟	F
刘建军	M
苏宝	M
曾继帮	M
杨明军	M
周玉祥	M
周丽芳	F
王溪合	M
蔡勤平	M
王薛然	M
李少江	M
赵精粉	F
许小秋	F
黄晓丽	F
李树波	M
刘颖	F
张荣风	F
刘学伟	M
于子龙	M
张营	F
熊振宇	M
周玉	F
李玲	F
刘莉莉	F
夏劲毅	M
马则给牙	M
谈航	M
陈国安	M
张志荣	F
王超	F
袁丁祥	M
刘曼文	F
艾文朝	M
冯青江	M
杜凤枝	F
马有龙	M
曾黔梅	F
陈志涛	M
李玉钢	M
徐华燕	F
张天文	F
张海霞	F
吕昆	M
王彦龙	M
高全东	M
张亚萍	F
陈雪佳	F
齐小强	M
张俊涛	F
胡新科	M
廖全民	M
孙梦云	F
袁小菊	F
徐文	M
朱文学	M
熊苗东	M
郜真真	F
赵明亮	M
蔡佳宝	M
麻海标	M
王天存	M
刘洋	M
余孜颖	F
于文龙	M
郑张平	M
周东旭	M
顾军强	M
张庆	M
王阳	M
何美玲	F
何星峰	M
郭明洋	M
王子涵	M
李成华	M
韩俊华	M
李营营	F
何晴	F
王团辉	M
刘欣茹	F
辛德彬	M
余亚男	F
陈达	M
潘靖明	M
江航	M
徐海洋	M
赵冠群	F
邓刚	M
黄高勇	M
陈友谊	F
李国凤	F
杨国庆	M
袁玉军	M
钱良跑	M
郭菲	F
邓超慧	F
谢瑞琪	M
李小霞	F
邱凤琴	F
缪泽波	M
周淼	M
韩珺	F
武利	M
刘然	F
平兆柱	M
李敏	M
许强	M
刘海龙	M
牛若楠	F
邹秀	F
李一	F
焦龙	M
余俊	M
杜敬强	M
孟庆卓	M
郭猛	M
刘培硕	M
王清武	M
曹辉	M
余丹	F
夏跃跃	F
陈淋	M
严瑞	F
钟应雄	M
侯长帅	M
魏子凯	M
秦亮亮	M
周相涌	M
曹海玉	M
杨赛赛	M
袁美连	F
沈黎哲	F
郭振兴	M
冀卓君	M
张艳	F
唐虎	M
王成	M
宗申龙	M
徐璐	F
李昂	M
曹旭	M
张恒	M
韩中华	M
熊毛毛	M
青德令	M
夏志鹏	M
韩瑞珍	F
张雄伟	F
郑博	M
任翔	M
刘清川	M
宋丽娜	F
曹洪德	M
李德凯	M
马晓龙	M
吕秋萍	F
朱江成	M
林强	M
朱海军	M
吴仁意	F
刘九生	M
童丽娟	F
董晓鸣	F
寿业帅	M
韩影	F
安红峰	M
李玲艳	F
陈秋月	F
方凤启	M
刘辉	F
马小龙	M
马佋金	M
邱正红	F
吴外芳	F
李建刚	M
王玉凰	F
邹梦琴	F
王亚文	M
杨富龙	M
许影	F
曹郭青	F
杨怀兰	F
刘生稳	M
李杰	F
王和忠	M
胡龙娥	F
杨卫军	M
叶百花	F
朱朝军	M
姜安	M
查敦华	M
李永恒	M
罗星	M
郭福建	M
楚德江	M
胡燕廷	F
柏威	M
李维	M
张自强	M
龚星星	M
周梓玉	F
魏玉风	F
周顶分	F
张泽旺	M
翟贵南	M
袁策	M
李启铭	M
贺明星	M
郑婉琨	M
余新花	F
赵华	F
翟居坤	M
车财妍	F
段本跃	M
林迪	M
吴晓芳	F
张春雷	M
熊英	F
伍海波	M
唐婕	F
沈凌炜	M
杨小敏	F
沈荣霞	F
林家民	M
李涛	M
陈艳	F
郝德友	M
张暑	M
马锦龙	M
鲍高峰	M
熊常强	M
熊祚星	M
马吉春	M
姬庆飞	M
张鹏飞	M
李再坤	F
王乾坤	M
王坤杰	M
闫晓强	M
张杭远	M
黄娜	F
吕厦军	M
李孝文	M
苏旺	M
周叶波	M
韦万良	M
许秀英	F
余志成	M
马红花	F
张宗占	M
蒋振喜	M
于中奇	M
程彩花	F
马林	M
宋志坤	M
何继飞	M
贾康华	M
张美芬	F
丁强	M
任翔翔	M
朱美金	M
饶名权	M
俞超	M
徐国平	M
冯才涛	M
蒋斯超	M
王玉成	M
周蓝心	F
谭永锋	M
孙健于	M
胡孝琼	F
刘艺帆	M
马飞吉也	F
陈庆烨	M
陈学清	M
何梦婷	F
朱冲见	M
张鑫	M
刘静	F
闫铭	M
韩建广	M
谢卫平	M
张妮	F
周书建	M
杜雨灵	F
丁宝妹	F
王正华	M
方维瑜	M
王文峰	M
李会祥	M
杜俊业	M
张旭阳	M
于永博	M
高影	F
夏腾武	M
郭先玉	F
刘玲红	F
周曦红	M
英芳明	F
孔梦云	F
龙权勇	M
周慈吉	M
陈方	M
范奇兴	M
伍竹青	M
刘书瑞	M
宋强	M
王成	M
冯江平	M
何永亮	F
冉中彪	M
苏连机	M
石岩	M
秦子峰	M
屈日炳	M
张力	M
黄岗	M
张玉林	F
冯洲杰	M
谌明展	M
李毅	M
蒋显聪	M
任荣会	F
魏佳明	M
陈剑雄	M
陈玉芳	F
马宇超	M
吴贝	F
罗朝鑫	M
丁东	M
赵丽	F
杨莹莹	F
王云川	M
王安	M
李高也	M
马利军	M
许敏霞	F
于文婷	F
盛利丽	F
谭海超	M
杨超	M
龙元香	F
蔡德康	M
蒋萍萍	F
周向红	M
刘杰	M
李玉琴	F
郭依平	M
宁利成	M
陈敏	F
徐帅	M
杨华	M
谢中山	F
宋密芳	F
李丽	F
毕大卫	M
鞠祁	M
梁永强	M
徐元元	F
孟凡侠	F
许玉奇	M
白杨	M
廖磊	M
牛庆祥	M
谢玉	M
邓小敏	F
罗朝胜	M
程志飞	M
周亚雪	F
杨金贤	F
张开业	M
赵静	F
申联蓉	F
姜春婷	F
于雷	M
鱼智龙	M
雷文超	M
杨华	M
宋慧莉	F
宋会珍	F
王士杰	M
刘晓霞	F
王明龙	M
周国庆	M
许雪莲	F
罗维聪	M
刘强仙	F
罗成	M
万明帅	M
马小霞	F
马海麦	M
王鑫	M
艾文龙	M
张博	M
李黎	M
吴云开	M
胡梅永	F
解玉凤	F
盛波艳	M
蒋达	M
周厚畅	M
艾致远	M
李想	M
涂凤凰	F
王永星	M
肖春林	M
夏文梦	F
于杨	F
卢发生	M
罗德江	M
李庆华	M
谢宾华	M
胡明烟	M
陈军	M
曹建荣	M
徐美华	F
王骄	M
范亮亮	M
杨丽情	F
李强	M
周锋	M
程来贵	M
曹和勇	M
罗坚强	M
廖雪花	F
戴东灵	M
李雪梅	F
唐远建	M
黄芬	F
邓淑林	F
杜骞	M
熊善武	M
姚宏	F
聂国香	F
陈秀梅	F
张德兵	M
丁爱兰	F
李金生	M
黄凤连	F
肖细华	M
沈国鑫	M
喻彪	M
焦锋	M
马文君	F
李荣伟	M
赵明阳	M
李铢灿	M
陈正亮	M
谷建明	M
万璞欣	F
洪桂章	M
周苏平	F
吴幸平	M
周小辉	M
杨剑	M
甄天涯	M
廖庆霖	M
张建飞	M
林聪	F
戴奇良	M
蒋丽娟	F
胡美京	M
陈月华	F
谢云	F
熊循龙	M
杨毓玉	M
钟伟成	M
彭桂兵	M
马勋靖	M
尹万根	M
杨佩	F
黄建娣	F
熊雪春	F
胡冬	M
桂预繁	F
代美芳	F
王晔	F
李永杰	M
吴露	F
王利	M
万东平	M
李婷	F
姚开乐	M
白云耀	M
高楼	M
万晓鹤	M
邓露	F
张铖伟	M
徐伟军	F
韩帅	M
王建安	M
陈中达	M
龚伟兴	M
蔡维林	M
郑定军	M
陈兰芬	F
冯如明	M
朱丽辉	F
周航杰	M
林小枝	F
张玥	F
李明珍	F
狄雪	F
刘玉婷	F
邓海泉	F
陈露露	M
耿乾坤	M
高艳敏	F
蒋何霞	F
陈斌杰	M
潘余彬	M
刘小明	M
张洪梅	F
李想	M
胡亚宁	F
胡万春	M
杨伟正	M
于蔷	F
李忠兵	M
裘知	M
张志远	M
周杰	M
褚燕飞	F
胡六妹	F
熊玲	F
王长妹	F
徐夏莲	F
唐赐碧	F
杨梦兰	F
李鹏飞	M
史亚丽	F
谭小清	F
李烁烁	F
王东先	M
周平	M
简文凯	M
何金凤	F
毛崇行	M
杨敏	M
董阳阳	M
王文静	F
张金荣	F
常任	M
伏春艳	F
许文波	M
邓峰	M
陈敬桥	M
田文博	M
江义乾	M
应道杰	M
周敦侠	F
赵心玥	F
李红光	M
钱龙	M
杨正君	M
洪启来	M
李伟	M
熊诵波	M
张晓倩	F
戴继伟	M
刘宾宾	M
张凤宇	F
李玉金	M
任莹	F
陈德操	M
丁磊	M
冷开江	M
林魏	M
罗昌红	M
单文杰	M
史雪	F
李润奎	M
邹娟娟	F
颜世凯	M
高艳兰	F
杨百明	M
魏醒醒	F
潘军伟	M
任春娟	F
李晓冬	M
张孝锐	M
金春	M
马海东	M
邵梦培	F
李强	M
陈徐韬	M
王阿平	M
王小平	M
齐磊	M
郜豪举	M
林海波	M
胡叶	F
张慧娟	F
徐广清	F
覃黎	M
郑佳佳	F
刘蓉	F
陈梨香	F
熊桂香	F
郭雪梅	F
辛小燕	M
耿佳发	M
陈明	M
孟杨	M
李婷婷	F
高丽春	F
谌雪刚	M
黄富	M
陈楚楚	F
姚嘉敏	F
李博媛	F
钱霜	F
俞嘉城	M
殷仲兴	M
王红强	M
鲍鑫磊	M
张洪涛	M
李军	M
赵中飞	M
郭凯	M
冷振	M
周航	M
朱瑞涛	M
张倩	F
周芳	F
蔡正美	F
任玉石	M
王功福	F
黄子诚	M
刘凤桦	F
王艳丽	F
卢斌	M
何佳	M
黄兴	M
贺强	M
黄威	M
龙小娟	F
舒倩	F
刘锟鹏	M
马佳逸	M
王昕	F
汪娟	F
余敏	F
苗清	M
李强强	M
杨胜江	M
张继录	M
陈清莹	F
陈燕津	F
王安	M
戴国军	M
濮维兵	M
郑孝浩	M
黄井清	M
张继军	M
张静	F
王晶冰	M
张博	M
高永安	M
鲜云风	M
张帅	M
赵颖	M
王款款	M
余国琴	F
刘富红	M
付廷军	M
郭玉洁	F
贠帆	F
杨乾	M
李兵	M
乔立新	F
陈金柱	M
苏吉霞	F
张殿涛	M
李时平	M
朱信英	F
闫巍巍	M
杨少锋	M
石金朋	M
吴凡	M
周杰	M
叶经康	M
陈俊华	M
万齐峰	M
卢志鹏	M
樊阳阳	M
王龙龙	M
张腾蛟	M
谷军建	M
陈伟聪	M
司徒增晓	M
牛鸿基	M
史小春	F
帅晶晶	F
郝宇	M
丁彩红	F
洪汪后	M
杨新文	M
韦春保	M
孙述梅	F
李颖	F
王宝宝	F
葛高磊	M
刘玉兰	F
秦韬	M
方锦辉	M
刘帅	M
孙云锋	M
张国林	M
朱晨	M
牛志远	M
吴月奎	M
马刚超	M
黄勇志	M
徐连花	F
张辉	M
安伟	M
张晓宁	M
郑寨军	M
李春梅	F
孙月红	F
刘博	M
张苏	F
李豪	M
夏康康	M
谢威	M
余小燕	F
汪广国	M
樊世民	M
孙培珍	F
宋阳阳	M
权分利	M
刘元成	M
李晓明	M
杨宇坤	M
张晓蕊	F
陈国强	M
熊露	F
张勋	M
李倩	F
胡火珍	F
周江艳	F
葛艳妹	F
徐桂青	F
陶振荣	M
姜毫毫	M
余梁	M
张宝林	M
赵清华	M
刘子凡	M
费丹丹	F
蔡平	F
胡莎	F
李钟	M
刘政通	M
梁金鑫	M
李登洲	M
王军	M
何新德	M
冯加琴	F
罗克司	M
石静波	M
胡长林	M
王文中	M
颜梦梦	F
李珍珍	F
唐水	M
胡建平	M
周紫航	M
张涛	M
张凌峰	M
韩贺龙	M
李健	M
邓杰	F
骆海宾	M
李泽波	M
程文龙	M
苏子豪	M
潘紫婷	F
陈永康	M
李欣	F
李云英	F
郭洁云	F
宋海涛	M
徐佳佳	F
拓宁宁	F
秦娟	F
施加敏	F
黄伟兴	M
赵曰强	M
王荣	F
张浩	M
李翠翠	F
唐念鹏	M
迟丽泉	F
杜甫	M
彭磊	M
杨炳攀	M
丁永亮	M
赵福军	M
陈争辉	M
代丹	F
殷李彪	M
周国彪	M
王洋	M
刘露	M
张凯	M
严文伟	M
石明刚	M
沈鑫杰	M
张永梅	F
赖小芳	F
周东海	M
吴帆	M
唐鑫倩	F
刘锋	M
张香传	M
金赛宝	M
马宇轩	M
文斌	M
余禧中	M
曹美秀	F
张宇	M
贾樱	F
侯学飞	M
张怀兴	M
张才富	M
彭忠国	M
彭忠福	M
刘亚辉	M
孙江涛	M
薛磊超	M
丁梦梦	F
唐金玲	F
蒋晨哲	M
张继红	M
马特	M
许利玲	F
邓金文	F
汪艳	F
高静	F
包思嘉	F
闫敏	F
林丽霞	F
高静	F
景阿强	M
臧一翠	F
谢菊秀	F
李梦祥	M
方益丹	F
廖勋志	M
王敏	M
朱子超	F
臧一垾	F
李梦娜	F
盛伟	M
尹成	M
王赫	M
赵洋	M
杨楠	F
陈雪梅	F
李宁	M
戎琳	F
崔海军	M
刘士坤	M
项正桃	M
黄丽	F
汤亚辉	F
刘秋林	F
崔庆毫	M
刘祥	M
李芙蓉	F
吴秋海	M
李娟	F
朱成永	M
陈晨	M
邱晨瑶	F
秦超	F
朱惠珍	F
李光恩	M
曹劲	M
张克剑	M
张腾	M
陈傲	M
徐方豪	M
陈强	M
项靖海	M
童博兵	M
曹改菇	F
卓双双	F
诸葛增祥	M
张琤琤	F
刘立威	M
孙浩	M
崔程琳	M
袁圆	F
宋光辉	M
李鹏鹏	M
颜伟航	M
郭宗庆	M
肖志远	M
吴丹丹	F
黄云	M
晁储政	M
汪美玲	F
刘楚云	M
常维巨	M
郑现娥	F
邬善勇	M
孙淑红	F
韩妍妍	F
伍冬	M
陈小莉	F
方黎晓	M
方林	M
袁亚芳	F
马吉泰	M
卢春杰	M
杨建刚	M
王文斌	M
李欣2	M
苑佳琪	F
陆佳龙	M
胡明	M
纪宏	M
李心如	F
胡坚坚	F
黄文琴	F
朱格志	F
周亭	M
马守军	M
韩保珠	F
冯硕	M
周宇	M
唐仙琦	F
陈巧巧	F
裴建强	M
李亚冰	F
任淋君	F
郑龙龙	M
张煜立	M
陈郎红	F
李勤付	M
吕隆飞	M
李茵	F
李文豪	M
蒋润泽	M
薛宏展	M
董燕	F
何剑锋	M
陈孟	M
黄明刚	M
王毅刚	M
金师师	F
孙思群	F
韩东阳	M
章建东	M
郑海勇	M
刘君达	M
陈秀凤	F
龚建伟	M
邱平	M
宋兴兰	F
侯军	M
沈武表	M
王练洪	M
张玉香	F
胡通	M
罗勇	M
何其坤	M
朱睿	M
林倩霞	F
刘稳欣	F
李林林	F
张万员	M
王凉	M
郭翔民	M
吴佳龙	M
周建兰	F
吴龙	M
吴小祥	M
毛义琼	F
杨俊	M
杨纪波	M
甘霞	F
钟勰	F
吴祥海	M
高海红	F
卜小刚	M
李平	M
任祥	M
喻先松	M
汪姣姣	F
王锡赞	F
杨震东	M
高小磊	M
叶露明	M
王晴晴	F
刘江	M
牛江明	M
陈浩	M
朱爱珍	F
曹远豪	M
裘德俐	M
高昱煊	M
王仁兴	M
辛震飞	M
陈君飞	F
童姝俊	F
李正午	M
董华康	M
侯丽峰	M
申艳	F
李英霞	F
张路远	M
王莉	F
罗哲	M
李新新	M
全建林	M
辛勇	M
廖珍	F
吴和国	M
靳延东	M
刘饶波	M
甘梦琴	F
李士宏	F
刘海超	M
张传啸	M
王小民	M
邓洁云	F
郝高赞	M
江爱芬	F
王笛	F
邓朝阳	M
李忠祥	M
敖燕	F
苏相相	F
方梦诗	F
徐彪	M
郑典芝	F
周勇	M
姬尧甫	M
史永梅	F
李行伟	M
洪亮	M
李海峰	M
王金凤	F
喻雯	F
张丽珍	F
赵鹏兵	M
胡朝兴	M
王建军	M
何龙龙	M
尚王梦	F
于秀秀	F
罗康	M
熊绍磊	M
马伟龙	M
刘蒙蒙	F
郑海宇	M
杨启鹏	M
胡荣军	M
叶成林	M
徐长青	M
熊丽君	F
程建文	M
吕丰钦	M
潘庆松	M
张帅兵	M
彭晓康	M
付玉军	M
廖君文	M
刘青松	M
姜少锋	M
庞杨洋	F
徐晨	F
刘缨娴	F
容世龙	M
杨林	M
石俊兴	M
严国华	M
张建华	M
杨凡	F
陈明	M
喻梅花	F
何慧	F
周晓敏	F
竺水中	M
张冬霞	F
王刚	M
余德田	F
徐亨星	M
施仁杰	M
丁铭	M
陈宾	M
杨围	M
赵亚东	M
李子波	F
张春美	F
李艺	F
唐红梅	F
李欢欢	M
王琴	F
郑力	M
胡星焕	F
李乾	F
肖佳俐	F
董冬冬	M
龚欣怡	F
王兰芳	F
毛琦琦	F
裘科栋	M
王凯旋	M
刘立波	M
朱正莲	F
郝伟	M
高龙威	M
郑时银	M
谭波	M
吴梦龙	M
明贤宝	M
林春华	M
汤寻武	M
胡晓	M
尹彦飚	M
张紫龙	M
李丽妍	F
肖水生	M
范凤连	F
徐叶富	M
俞小招	F
尹洪磊	M
朱礼平	M
马骁	M
李真满	M
易浩	M
薛林浩	M
曹蕾	F
凌立亮	M
许磊	M
陈金南	M
黄汝松	M
陈红艳	F
杨金辉	M
黄钰蕊	F
徐伟	M
张庆霞	F
王闯	M
邓吉芳	M
张现利	M
倪爱华	F
杜佳	F
李茹	F
任春莉	F
叶行坤	M
余敏	F
兰丽君	F
王大庆	M
丁鹏	M
陈建	M
张虹霞	F
陈宏达	M
郭友森	M
周春燕	F
赵梦姿	F
刘晋宇	M
孙洪超	M
王华	M
李青	F
宋承敏	F
于曼曼	F
陈川	M
赵行	M
韩彩娃	F
张玲香	F
娄文华	F
聂文广	M
张晓新	F
梁娟	F
吴桂平	M
田会颖	F
张国强	M
朱艳荣	M
叶涛金	F
唐海英	F
陈慧	F
魏胜伟	M
胡晓英	F
陈俊	M
张春梅	F
陈程	M
王港生	M
胡龙辉	M
万云	F
胡由校	M
张婷婷	F
潘艳	F
周建红	F
曹玲多	F
华晓利	F
柯占刚	M
行雨璇	M
刘晓倩	F
曹理平	M
张镁铃	F
吴娇娇	F
马钟伟	M
马长鹏	M
程春玉	F
陈锦阳	M
胡丛丛	F
王宁	F
邢娅群	F
唐国艳	F
姜丽蓉	F
黄静霞	F
舒丙亮	M
陈兵	M
崔朝帅	M
廖超	M
陈德芳	F
陶文斌	M
丁志远	M
王薇薇	F
吴琼2	F
胡亚杰	M
吴九磊	M
吴宗宪	M
沙国海	M
王守佳	M
王建红	F
王华坤	M
赵永刚	M
黄秀清	F
吴梦妮	F
周建良	M
邓朝皇	M
杨喆	F
余彬	M
李建桐	F
万志强	M
李慧	F
张申琼	F
刘美娜	F
黄奇聪	M
熊玉强	M
孟明	F
韩冬	M
汪媛	F
徐正田	M
张宏民	M
石立芳	F
伏奎宗	M
林素素	F
刘辉	M
张开新	M
邵婉琴	F
王建来	M
王果	M
李亮	M
范希俊	M
崔召平	M
严方新	M
张文博	M
李欢欢	F
黄晓倩	F
黄小萍	F
窦红伟	F
王玉林	M
马凯迪	M
张丽	F
瞿嗣超	M
胡玉萍	F
陈永花	F
刘国浩	M
黄金彪	M
陈燕	F
雷霞	F
缪丽娟	F
熊莹	F
尚艾米乃	F
陈鹏媛	F
孔伟伟	M
敖应忠	M
李万龙	M
阳学谦	F
王钱高	M
梁柱文	M
李强	M
马晤	M
王大翔	M
吴春芽	F
赵磊	M
王君美	M
古雪飞	M
邵博文	M
吴亮亮	M
陈德新	M
章一聪	M
马金山	M
徐明晶	M
郑豪	M
王雅菊	F
郑雅丽	F
刘嘉雯	F
侯杰	M
胡志志	M
殷瑞	M
张志豪	M
姜竹花	F
刘永兴	M
王林川	F
陈优胜	M
曹旭	M
丁波	M
尹柯	F
汪佳	F
钱米茹	F
陈存国	M
武军	M
吴小草	F
张洋洋	M
邹小辉	M
张立新	M
邓梦乔	M
刘婷	F
吴肖娜	F
刘海洋	F
靳增	M
雍恒	M
齐金梅	F
杜平飞	M
陈飞娥	F
徐帅	M
张路	M
胡安琪	F
金鹏翀	M
陶东山	M
王志国	M
郭岩	F
杨军	M
杨当利	F
朱雷鸣	M
张飞飞	M
吴海豹	M
张伟	M
龙尚松	M
张浩亮	M
李青龙	M
余军	M
杨春香	F
刘晨	M
关微	F
相金攀	M
孙建君	M
孙余良	M
赵西力	M
刘剑	M
郭春强	M
秦继美	F
李翠红	F
刘王凤	F
黄帅	M
黄娟	F
刘乾	M
陈千	F
郑孟泽	M
韩帅南	M
曾细欢	F
郭沙沙	F
郭富琪	M
赵颖蓉	F
卢忠凤	F
卢洪强	M
杨强	M
李刚	M
崔益虎	M
卢丽华	F
张珊珊	F
葛恒业	M
张祖海	M
周玮怡	F
陈磊	M
彭顺	M
刘绍芳	F
郝亚娜	F
毛成福	M
耿德尚	M
朱虹	M
刘年庆	M
胡甘露	F
高宁祥	M
刘导	M
段朋瑞	M
吕鑫行	M
武智霖	M
胡振	M
王崎	M
王如军	M
梁中华	M
农桂彩	F
余小恒	M
雷登元	F
周浩亮	M
庞辰超	M
范丽萍	F
李传禄	M
徐华涛	M
宋家兴	F
张宗鹏	M
原晨	M
吴怀文	M
李晗	F
戴莉莎	F
汪自力	M
张伟	M
鲁楠	M
张梦瑶	F
李思霞	F
谢小松	M
郑宏光	M
程枝	F
李游	M
杨明	M
尹飞平	F
张文杰	M
林西川	M
陈小华	F
随小群	F
何成虎	M
高志慧	F
邓世明	M
钟武辉	M
李庆	M
张东	M
韩甜甜	F
崔忠冠	M
何艳	F
邢鹏	M
范超	M
夏卓佳	F
武雪军	M
李安军	M
张飞飞	M
周毅	M
王政	M
夏亮	M
赵立志	M
车雅萍	F
王志侠	F
裘盛花	F
黄宗浩	M
张明明	M
张艳春	F
黄闽	F
梁磊	M
任煜	M
李博涛	M
何双江	M
杨云杰	M
陈艳	F
杨加东	M
郑大为	M
孙兰兰	F
刘竞泽	M
刘欣	M
蔡源泽	M
杨园亮	M
马锦涛	M
孟方方	M
徐忠建	M
余俊强	M
李亚辉	M
朱珏岚	F
朱若莹	F
吴象	M
杨亚旭	M
姚军勇	M
荆岩喻	F
苗康	M
李海斌	M
邹博	M
江竹坚	F
王冰冰	F
胡玲佳	F
聂选欢	F
费晓青	F
陈林根	F
严婷	F
徐树明	M
马泽英	F
马治国	M
赵清	M
夏蔡文	F
贾乐辉	M
胡娟	F
赵海燕	F
何磊	M
张余梅	F
张梅梅	F
石惠	F
钦丽	F
罗栋	M
郭恒发	M
郑充	F
唐寅桑	F
姜俊敏	F
马辉	M
方序	F
曹西静	M
冯晓佳	F
江金灼	M
阙小虎	M
裴艳辉	M
闫欢	F
王金珠	F
帅飞	M
秦佳圆	F
罗建安	M
马文斌	M
李金伟	M
朱梅英	F
陈洪冲	M
孙显东	M
潘亦登	M
迟鸿明	M
叶帅	M
赵广东	M
代云鹤	F
褚崇辉	M
郭旭东	M
李小林	F
方浩宇	M
王富磊	F
宁太兴	M
毛祥在	M
许光明	M
唐顺民	M
褚光彬	M
储东林	M
王重阳	M
王佩	M
王浩文	M
方遗周	M
何孝贵	M
章艳泓	F
云集	M
林琪	M
童明升	M
吴小燕	F
钱书琴	F
续林雄	M
赵子龙	M
李楚楚	F
木承础	M
绳家艳	F
董晓雷	M
陈兴华	M
钱瑞东	M
何花	F
朱伟清	M
崔阳明	M
蔡子真	M
陈冉	M
谭礼宇	M
朱丽娜	F
周勇建	M
吴新炉	M
宋世豪	M
石云龙	M
王刚玲	F
程捷	M
沈丽江	F
田明宝	M
罗应平	M
黄飞	M
周一峰	M
牛志涛	M
赵德银	M
陈兵	M
张健	M
张梦婷	F
万经辉	M
韩佳霖	F
徐迅	M
陈辉	M
张廷玉	M
李冬升	M
张阳阳	M
贾海荣	M
方贤波	M
廖忆慧	F
扈小江	M
史迪文	M
蔡洁洁	F
郭飞	M
王博强	M
况元刚	M
邱力	M
李静奇	F
周霞玲	F
张振华	M
夏晓虎	M
马世龙	M
马玉有	M
曹孝象	M
吴启波	F
赵欣	F
陈绍镇	M
石微	M
马金梅	F
张旭天	M
薛欣茹	F
张康浩	M
刘晓闯	M
陈贺	M
吕小勇	M
林金欣	M
盛晓平	M
王镇涛	F
许令红	M
周迪	M
谢梦琦	M
唐高飞	M
黄云	M
周志海	M
周元琴	F
杨宁	M
黄静	F
曾万霖	M
叶鹏	M
于琪	F
田红梅	F
洪瑜峰	M
彭林林	M
恽晨祺	M
青野正弘	M
张辉	M
杨芳琴	F
熊汗冬	M
焦书帅	M
张戌晨	M
江华	F
谢剑花	F
张国龙	M
刘俊杰	M
刘英杰	M
赵克辉	M
许梦婷	F
谭恒海	M
黄泽文	M
王梦园	F
陶侕节	M
胡梦	F
龚元元	M
任惠塘	M
曹燕	F
唐辉德	M
赵玲灵	F
徐亚锋	M
熊喜庆	F
黄艳丽	F
王业鹏	M
王英花	F
侯连浩	M
耿帅	M
聂耀婷	F
喻雪平	M
杨仙琴	F
吴嘉锋	M
陈根陆	M
万齐标	M
余昌平	M
陈帅	M
熊玲玲	F
邓金桂	F
倪禹	M
刘贺	F
邓叶岚	F
安明健	M
张彦娇	F
刘富炳	M
杜佳鑫	M
蒋文波	M
王蕊	F
雷明明	M
郑吉龙	M
张军	M
李绍刚	M
郁道旭	M
米杰	M
李茂平	M
徐冬冬	M
黄贻兴	M
杨小花	F
杨战扬	M
周祎	F
徐静	F
鲍丙飞	M
马金香	F
钱燕丽	F
汪旭琴	F
鲁立峰	M
马哈比白	F
陈星	M
龚一木	M
雷迎禄	M
潘玉琴	F
王朝阳	M
程志龙	M
王明	M
曾明	M
王虹策	M
苏苏目	F
徐敏	F
刘杨	F
王丽	F
王德兵	M
胡月星	M
李志侠	F
夏秋	F
缪雨佳	F
孙帅	M
黄琴琴	F
陈香琴	F
王晓丽	F
余桂宝	M
唐桂兰	F
胡雪妍	F
万长友	M
汤生衍	M
孙宇航	F
李谈	F
许亮亮	M
周瑞君	F
马啥米东	M
陈翠娥	F
吴凤玲	F
钱利	F
张丽超	F
齐猛	M
夏鹏	M
朱正奇	M
施健骐	M
胡田田	F
宋影	M
黄勇	M
刘文生	M
方洁	F
韦昌	M
苏震	M
李强升	M
陈娜娜	F
张朝凡	M
张苗	F
卢林俊	M
高小龙	M
宋能	M
李诗刚	M
吴雨蔚	F
邓斌武	M
高田田	F
零恩泽	M
王超越	M
杨小军	M
张蛇平	M
冉曼曼	F
何江庆	M
梁光磊	M
韦伟	F
宁珊珊	F
周佳佳	M
王增富	M
杜军	M
闫家兴	M
杨美玉	F
李成会	M
张静	F
曹之标	M
李双哲	M
汪学雄	F
李松	M
王季	M
花木	M
董官振	M
刘文祥	M
王阿哈麦	M
廖金凤	F
刘东旭	M
颜华君	M
王英涛	M
张志峰	M
谭锦	F
马太力哈	F
杨楠	M
张苗苗	F
米承华	M
谢松斋	M
闫海军	M
杨艳欣	F
马慧	F
吴庆华	M
朱明	M
蒋翔宇	M
邓勇	M
杨军	M
汪嘉文	M
李小玲	F
令狐代洪	M
陈定妃	F
袁华	M
张红新	M
付双双	M
蔡硚	F
苏辉安	F
魏文康	M
杨小汉	M
周明武	M
贾志伟	M
张籍文	M
宋冬冬	F
魏丹丹	F
朱宁	M
谢国明	M
陈文波	M
王林	F
贾军	M
李宝妹	F
胡文斌	M
刘国花	F
郭娇娇	F
朱洪建	M
胡林海	M
石春艳	F
董春强	M
周磊	M
梁俊峰	M
卢永康	M
孟献月	F
李文强	M
王海光	M
高玲英	F
田洪志	M
郭春方	F
张甜甜	F
付江豹	M
朱凤勤	F
钟纪良	M
黎玉华	F
吴旭东	M
徐宇	M
刘志远	M
万丽丽	F
张坤	M
徐金星	M
章旭楠	M
张朋星	M
汪承玉	F
陈花霞	F
陈洋	M
杨建清	F
马玉侠	F
叶佳敏	M
毛修鸿	M
余心乾	M
沈姣	F
胡昊	M
王润澜	F
张友志	M
李德平	M
陶志豪	M
杨桂文	F
周春来	M
高文杰	M
何佳俊	M
王小军	M
熊飞黄	M
张朋	M
王元国	M
郑强	M
彭道伟	M
娄一俊	M
陈丽君	F
廖海军	M
张鹏	M
李天鹏	M
马宝庆	M
袁文康	M
张国龙	M
周琳	M
余章旺	M
汪金萍	F
丁森	M
闵道清	M
王维菲	M
吴东	M
江峰	M
蔡梦静	F
彭宜松	M
冯冰	M
田江	M
华蓉	F
周旭暖	F
韩雨婷	F
凌文丽	F
谢强	M
王亮	M
黎鹏强	M
陈大全	M
陈爽	F
李智慧	F
熊新为	M
许宇达	M
杨子凯	M
彭丽娜	F
王登强	M
刘国旭	M
李明明	M
刘海龙	M
李俊阳	M
肖华	M
叶淑芳	F
罗敏英	F
陈勇	M
赵兴臣	M
欧林春	F
王萌	M
何梦	F
刘文娟	F
侯俊	M
李坤	M
蒋世良	M
许荷琴	F
周俊霞	F
蔡丽萍	F
邹金珠	F
王成君	M
程娇	F
黄学能	M
丛阳	M
王雪	F
戴阳惠	M
赵丹	M
袁琴	F
马闯	M
刘芬	F
汪帆	F
陈丽琴	F
陈清	M
余乐	M
刘倩	F
苏双	F
王锐	M
王搏涛	M
刘彩霞	F
李硕	F
张华琦	F
赵亚苹	F
刘应林	M
武涌	M
徐天成	M
李春雷	M
郭伟成	M
潘维维	F
赵凯强	M
张德功	M
周银涵	F
崔维萍	F
孙浩	M
冯永会	F
闫洪帅	M
李琴	F
高朋	M
张燕	F
胡智龙	M
董亚鹏	M
张晴	F
路家荣	M
吴银梅	F
胡菊华	F
刘方	M
佘海洪	M
陈宇	F
黄仁辛	M
王兴燕	F
赵先斌	M
李忠军	M
杨世杰	M
傅海刚	M
赵二宝	M
姚威	M
黄园芳	F
王琴	F
王海芝	F
梅军淼	M
宿晨	M
陈默	M
龙长智	M
叶冬冬	M
王佳孜	M
史丽君	F
赵冬来	M
涂继禄	M
谢红平	M
刘宁宁	F
王晨路	M
毛雨阳	M
银庆玉	F
李斯珂	M
李吉	M
董凯磊	M
潘后阴	M
周建祥	M
凌晓	F
张会腾	M
励波	M
李恩圆	F
田学丹	F
杨林颖	F
王展津	M
刘天阳	M
李灯源	M
韩冬	M
王梁	M
徐成玥	F
焦裕坤	M
刘建国	M
王利芹	F
洪旺君	M
郝荣敏	F
王长英	F
朱承汉	M
张大铭	F
刘泽贤	M
谢丽	F
马小天	M
葛冬娟	F
陈帆	F
姚俊俊	M
张育强	M
张伟	M
刘强	M
张甲乐	M
阚学亮	M
李兰	F
肖媛	F
杨豪	M
尤良岳	M
邓新文	M
曾俊喜	M
鄢成	M
张辉	M
吴志鸿	M
赵静	M
郭应琼	F
尹婷	F
陈志强	M
裘文锋	M
李学智	M
白泽宇	M
吴吉君	F
彭启军	M
韩光辉	M
朱云	M
朱建超	M
张景林	M
李伟	F
廖争艳	F
郭静安	M
王双梅	F
吴燕	F
张娟	F
高燕广	M
陈亮	M
刘强明	M
马关运	M
杨瑞月	F
施丽敏	F
李国柱	M
吴家新	M
汲兵倩	F
郑景涛	M
韩英才	M
夏佳佳	F
陈晶晶	F
唐鸣	M
裴梦瑶	F
沈佐胜	M
徐一平	F
梁志强	M
周凌志	M
来宝	M
王丽荣	F
高江豪	M
戴勇	M
吴爱丽	F
唐海	M
肖飞	M
程明亮	M
郭素素	F
郎慧超	M
吴帅	M
吴静波	M
刘佩	F
宋春水	M
司访	M
吕春义	M
许大龙	M
朱虹艳	F
潘蓉	F
熊玉丽	F
马江雪	F
龙琳	F
钟继光	M
唐秋兰	F
郁洁	F
张建伟	M
王辰辰	F
熊秋秋	F
张仰水	M
王路遇	M
韩超	M
鲍先涛	M
白晓青	M
吴丽华	F
杨平	M
石峰	M
罗鹏宇	F
杨海月	F
朱思华	F
莫平	F
王琛	M
冯芬良	M
张双喜	M
闫起超	M
刘澳	M
刘富	M
巴园芳	F
常亮	M
罗小芬	F
陈俊安	M
杨磊	M
杨乐	M
汪瑛	F
江泽亥	M
万瑞祥	M
熊慧芳	F
曹志超	M
连扬凯	M
李伟	M
邱亚飞	M
葛秀文	M
刘元兵	M
戴兵	M
金品品	F
廖良保	M
姚璐璐	F
陈丹丹	F
陈磊	M
周雪冰	F
熊东华	F
孙燕	F
石影	F
闫鹏	M
尤志标	M
李纯良	M
杨辉福	M
王军	M
谭春花	F
樊友宝	M
梁猛	M
梁建	M
熊志文	M
唐瑞	M
周志杰	M
任唯杰	M
厉赟	M
周杨秋	F
诸备芳	F
叶妙君	F
王增山	M
赵明鑫	F
张莉	F
郑晓红	F
何云庆	M
黄能玉	F
周文霞	F
孟令超	M
钱承	M
自云德	M
王金花	F
伊海莲	F
孙伟	M
魏海燕	F
刘桂辉	M
夏丁英	F
杨金龙	M
雷伟刚	M
苏华松	M
陈兰	F
茹国良	M
邓龙凤	F
赵成	M
陈庆腊	M
李森	M
吴春妍	F
陈水乾	M
徐红	F
郑建良	M
徐恩芬	F
李海通	M
兰港	M
汝黎明	M
方晶	F
鲍红霞	F
周谷平	M
陶月红	F
王志龙	M
王霞琼	F
姜冬华	M
王艳平	F
傅方花	F
吴玉霞	F
张善君	M
严祖立	M
竺建波	F
周杏玉	F
李晓倩	F
杨江辉	M
余德江	M
彭勇	M
施水波	M
胡裕桐	M
钱林洋	F
孙云霞	F
李红倩	F
曾利云	F
罗小女	F
竺鋆	M
王养儿	M
蔡蕾	F
蒋惠	F
吴巧玲	F
卫海全	M
袁琴	F
洪颖	F
李桂容	F
陆艳	F
袁志民	M
尹淑萍	F
郑霞	F
连建萍	M
叶意波	F
王新兰	F
宋欢	M
陈宇航	M
周健军	M
吴朋妃	F
舒亚楠	F
周燕	F
张志领	M
卢艳	F
冯松杰	M
范爱华	F
姚林忠	M
康玉琴	F
林松涛	M
周丹云	F
杨文武	M
谢如国	M
崔美云	F
胡浩明	M
罗斌	M
边红杰	M
刘华恩	M
吴微波	F
孙卫强	M
竺波	F
王雪	F
朱友军	M
张美玲	F
卢金花	F
徐奥博	F
杜秋香	F
白兴云	F
蔡超强	M
余传军	M
曲卫晓	M
谭建英	F
万丽	F
涂华英	F
尹姣	F
万雪花	F
史飞	M
徐方仁	M
吴福云	M
徐支永	M
严峰	M
夏香改	F
张正成	M
虞玲珠	F
向雄	M
茅启荣	M
刘兴梅	F
叶素红	F
崔科峰	M
陈莉莉	F
孟艳云	F
吴福云	M
徐永前	M
吴君海	M
明军	M
刘微萍	F
夏美霞	F
孟二利	M
刘良慧	F
谢思芳	F
张华英	F
张良涛	M
孙荣	M
高进	F
郑诗朋	M
项红林	F
况克才	M
周立勇	M
肖云	F
娄琳娜	F
李鹏	M
陆忠华	M
雷红平	M
胡余发	M
邓婷	F
罗朝辉	M
万泽钊	M
聂跃兵	M
王珊珊	F
汪敏龙	M
兰青	F
毛朝阳	M
王琪媛	F
王传登	M
应钢	M
吴银彪	M
陈飞	M
刘红刚	M
王先明	M
孙桂芳	F
崔微娜	F
江君	F
雷长立	M
黎迎	F
郑意弘	F
邹娣婷	F
胡喜荣	F
徐英豪	M
陈锡浓	F
刘英敏	F
徐樱	F
张淑艳	F
谢旖旎	F
周兴武	M
潘齐亮	M
杨仙娟	F
缪静燕	F
汪正英	F
吴海燕	F
毛群	F
田幸巧	F
刘国节	M
甘雁	M
白豫洪	M
王一珺	F
王红光	M
刘建平	M
谢建国	M
刘安汪	M
雷小云	F
周灿敏	F
范传海	M
杜传弟	M
李八妹	F
秦明俭	F
周双芬	F
谭前波	M
何强	M
王自虎	M
魏星	M
施丽芳	F
施建伟	M
金俏	F
刘俊	M
杨彪	M
王金桥	M
蒋星宇	F
徐兰飞	F
李婷婷	F
张军斌	M
李孟元	M
黄红波	F
赖正松	M
王菊蓉	F
张朋明	M
仇亚明	F
孔祥媛	F
张兰芬	F
孙伟伟	M
刘艳	F
郑伦祥	M
李长勇	M
李蒙	F
田梅芝	F
杨建军	F
陈婕	F
金路	M
吴定海	M
曹仲利	M
陈文唯	F
陶连华	F
朱小斌	M
毛洋森	M
杨黎嫆	F
付纪凤	F
缪锡雷	M
张健	M
金世育	M
郑伟	M
方科代	F
徐嘉祥	M
陈彦	M
杨立全	M
马祝飞	F
邱书芹	F
寇志成	M
杨何	M
沈莉莉	F
金齐燕	F
张雄英	F
杨福花	F
张晓东	M
韦良华	F
江芬	F
钟露露	F
邢祝贺	M
叶利服	F
冯庆陆	M
李恒秀	F
何志定	M
曲学平	M
王亚飞	M
罗燕萍	F
叶国荣	M
韩波	M
陈能波	M
郑有华	M
张雷达	M
陈位能	M
陈贵妃	F
陈帅	F
杨恩岳	M
练恒大	M
王朝辉	M
王玉君	M
陈剑平	M
陈央芬	F
马超	M
王冬凌	F
王小保	M
章润	F
熊应英	F
吴涛	M
陈敏捷	F
朱朝廷	M
焦凯燕	F
严国君	M
郑彪	M
张云峰	M
郁欢	F
周明宏	M
俞可方	M
徐罗剑	M
翁其理	M
王光军	M
黄寅杰	M
汤伟浓	F
呼延海平	M
肖春花	F
鲁亚娟	F
吴存君	M
陈玉娣	F
郑红苏	F
洪建位	M
陈丹丹	F
陈寿猛	M
王东贤	F
周清	M
黄龙	M
石燕华	F
刘金秀	F
薛肖肖	F
臧志红	F
周晨璐	F
况海萍	F
李慧	F
张友明	M
杨清龙	M
谢升武	M
范晓晓	F
杨永松	M
左斌	M
周宁	M
陈芬球	F
梁维博	M
李孟年	M
王帅	M
郑和勇	M
陈海儿	F
李维晴	M
崔夫良	M
严亚蕾	F
郑志考	M
王君亚	F
张锦松	M
陈锡军	F
管春华	M
周峰	M
应朝	M
车玲玲	F
马恒强	M
徐重	M
王家伟	M
牛延君	F
陈茂进	M
张帆	F
章跃平	M
王秀玉	F
黄爱民	M
刘校峰	M
周蕾	F
顾浔丰	M
袁莲英	F
刘君	F
范素端	F
李玉萍	F
王增良	F
郭彩萍	F
仝朝	M
万敏	F
王园	F
李丽平	F
冉杰弟	F
范继胜	M
李心旺	M
帅秋玲	F
汪茶香	F
董勤勇	M
汪红远	M
罗玉梅	F
曾春萍	F
张祥丽	F
兰飞	M
李国杨	M
余群	M
詹念念	F
阴晓红	F
杨婷婷	F
王治富	M
张彬彬	M
万春花	F
蓝春林	M
林俊超	F
张竹松	M
鲁宜凤	M
刘波	M
邹小兰	F
王文冲	M
张博博	M
张玉	F
李树民	M
陈洁	F
赵智歆	M
程春香	F
李金蓉	F
王小枝	F
张志君	M
李美兰	F
吴军	M
俞春兰	F
钱建尔	M
王亚	M
黄水文	M
孙海英	F
赵玉刚	M
郭玉清	M
文峰	M
万春华	F
廖武志	M
聂香枝	F
张洁	F
陈虎	M
曹永发	M
玉丽娟	F
肖雪花	F
田炜	M
梅新	F
王勇	M
冯丹荣	M
冯化方	M
熊卿兰	F
杨蒙	M
符小爱	F
黄彪	M
肖丹丹	F
彭三毅	M
李青根	M
李伟	M
王孟宏	M
方琪	F
王华莹	F
赵苏超	M
鲍武	M
白乃波	M
陈权	M
郑曹霞	F
方隐	M
姚建亮	M
盛文禧	M
蔡龙英	F
杨海	M
陶竹	F
郑富均	M
熊木英	F
谢秋华	M
韦金连	F
邵红聚	M
雷丛林	M
俞其康	M
谈仔玲	F
李翼文	M
黄健	M
季光萍	F
刘涛	M
吕萍	F
陆堃	M
林秀琴	F
贾小云	M
尹巧花	F
陶佳根	M
宋姗姗	F
姜颍颍	F
任涛	M
杨剑	M
宋宪宏	M
董佳丽	F
陈金香	F
周秋芳	F
彭卫	M
李贵胜	M
张桂飞	F
朱国华	M
于鸿君	M
熊汗典	M
黄丁	M
姚徐飞	F
俞斌斌	M
庞士婉	F
张圆圆	F
杨远坚	M
马关艳	F
张良金	M
王海俊	M
张金鹏	M
曾坤坤	M
应敏吉	M
覃艳芝	F
卓倩吉	M
王艳	F
王显平	M
张丽霞	F
孟良	M
熊义芳	F
叶春虹	M
葛剑平	M
闻清	F
陈晓	F
胡曼	F
刘勇文	M
谢祝平	F
杨学涛	M
唐再忠	M
纪影	F
顾伟一	M
齐晓风	F
李军	M
顾丹燕	F
邓龙	M
陈康	M
尚伏红	F
吴汉平	M
李立波	M
陈怡	F
武启龙	M
胡培培	F
熊燕	F
陈姗姗	F
夏玲	F
黄玲	F
王荣己	F
崔维娜	F
张武海	M
王柳英	F
张志军	M
张金英	F
朱军峰	M
薛阳富	M
欧阳娟	F
王长春	M
王平	M
杨君	F
宋路军	M
张均平	M
赵龙	M
王澄澄	F
罗烈妹	F
鲁文行	M
杨智明	M
汪冬香	F
易传贵	M
鲍婕	F
杨红梅	F
陈焕	F
赵永山	M
周云华	F
邓兵华	M
潘玲丹	F
尹磊	M
李维花	F
罗小兰	F
黄茜茜	F
冯林	F
张文强	M
李卫荣	M
王彦芝	F
方满红	F
陈晨达	M
林怀彬	M
吴斌	M
葛能虎	M
赵丹丹	F
袁思芬	F
袁恩武	M
汤鹏程	M
王德飞	F
李永梅	F
唐天	M
郭锦	M
伏翠翠	F
程显桂	F
黄青青	F
孙诗红	M
胡家明	M
张宏康	M
王华利	F
李浪	M
魏玉林	F
杨玉华	F
李春冉	F
李昌怡	F
何永华	M
刘建蕊	F
董丹丹	F
曾文娟	F
王伟	M
王风燕	F
李萍	F
毕奇宏	M
左丽婷	F
张倩	F
陶涛涛	M
朱颖	F
汪功本	M
黄艳	F
章玥玥	F
胡惠芳	F
刘花香	F
任红兰	F
谷国彦	M
廖爱平	M
平灵芝	F
张哲	F
练高峰	M
叶均号	M
王明科	M
邱娟芳	F
陈军	M
许伟国	M
王雪红	F
任家力	M
张云龙	M
赵文表	M
李建荣	M
刘菊华	F
吴宗玉	F
毛永光	M
应红斌	M
傅浪静	F
阳露	M
李章勇	M
袁硕	M
黄波	F
李波	M
余霞	F
季艳红	F
陈英	F
周莹	F
罗月萍	F
谢玉莲	F
封纪成	M
金文珍	F
王秋丽	F
郑哲	M
王瑛	F
杜二妹	F
陶学盛	M
毛丹萍	F
景君龙	M
张乾坤	M
王亚琦	M
邹文龙	M
熊磊	M
吴晓兰	F
孙灯青	M
李伟	F
陈云良	M
陈汝红	F
翁挺	F
王曼	F
陈伟江	M
郭小伟	M
李小飞	M
寇雪婷	F
陈忠梅	F
郑威弘	F
罗俊	M
粟彬彬	M
马有龙	M
申风光	M
张雪辉	M
樊晓林	M
王芳	F
刘健	M
尹满旺	M
叶红园	F
喻淑云	F
吕佳南	F
马金同	M
董克涛	M
陈斌杰	M
许亚克	M
吴今平	F
金明智	M
蔡真换	F
毛姗姗	F
彭顺娣	F
高爱英	F
王伟	M
李小英	F
毛军英	F
涂继云	M
杨杰亮	M
李霞	F
胡文	F
董永明	M
陈欢	M
林远一	M
邬香伟	M
潘军	M
魏明明	F
张吉康	M
尹小涛	M
谢莹	F
陈强	M
陈科	M
吴素安	F
张凯飞	M
倪华美	F
方林翠	F
刘珊珊	F
贺斐	F
刘存叶	F
戴克锋	M
党旭	M
徐武强	M
刘宁	M
单春兆	M
盖辉	F
朱伟	M
杨迎伟	F
张艳侠	F
陶侕箕	M
刘学金	F
谢虎	M
黎燕	F
蒋安全	M
徐德星	M
胡永锋	M
余欣	M
许威华	M
盛直海	M
俞坤	M
王振	M
沈兰萍	F
吴叶江	M
崔伟业	M
应必业	M
徐文彪	M
龙建	M
孙斌辉	M
张瑶	M
金维平	M
叶靓媛	F
顾利军	M
胡梅咏	F
孙龙茂	M
张连增	M
杨占国	M
孟玉新	F
徐敏业	M
陈桂芳	F
冯贵财	M
崔伟君	M
熊鑫	F
蒋振鹏	M
刘世勇	M
于海超	M
陈媛媛	F
李旭阳	M
张欢	M
徐琪峰	M
徐运平	M
武东利	M
万仟	M
叶玲	F
贺佳苗	F
杨艳	F
李太兴	M
唐浩永	M
施卫卫	M
杨阳	M
洪勤勇	M
杨盼	M
陈巧阁	F
张俊锋	M
吕瑞兰	F
肖春龙	M
胡明星	M
余慧敏	F
张英	M
沈毓原	M
武超	M
卢志航	M
方宁	M
龚姣	F
沈佳宜	M
姚旭峰	M
陈前雄	M
金永伟	M
王戴生	M
熊吕波	M
陶冬兰	F
谢海金	M
李继礳	M
陈良明	M
王华	M
符铮	M
王爱玲	F
万齐虎	M
刘素线	F
丁晓良	M
钟荣连	F
彭杨意	M
徐柯锋	M
王凯	M
邓飞叶	F
汤秀虎	M
黄胜强	M
沈楠楠	F
杨永华	M
楼德华	M
苏春梅	F
程建	M
杜朋辉	M
彭志文	M
范阳	M
吴双勋	M
唐坚	M
王树峰	M
查国里	M
叶文	F
马红燕	F
李云	M
陈佳波	M
罗金水	M
翟宏达	M
杨凯	M
刘树东	M
万莲	F
冯志强	M
王碧容	F
邢振冲	M
杜玉婷	F
程志刚	M
童晓红	F
何林梅	F
李金成	M
卓美芳	F
魏鹏	M
欧金波	M
杨旭宇	M
董鸥葶	F
黎英芳	F
石小林	F
苏海宁	F
郭申堃	M
黄娟	F
王艳	F
张选琼	F
白铎平	F
张龙裕	M
邱运	M
刘春花	F
徐小凤	F
凌发银	M
俞润毅	M
文涛	M
蒋磊	M
朱文琪	F
陈爱利	F
李光旭	M
陈佑儿	F
蔡娜娜	F
李小倩	F
赵保卫	M
田丽彬	F
伊淑鸿	F
马水燕	F
杨大康	M
陈觉斌	M
郭保林	M
杨美光	M
严韦萍	F
王艳	F
丁永星	M
王丽	F
叶咸德	M
李辉辉	M
熊明强	M
卢婷	F
蒋仕菊	F
戴强	M
张觎	M
袁洪伟	M
尹小刚	M
宾兰	F
王骏	M
魏士霞	F
颜伟	M
何志琦	M
张海超	M
饶情情	F
易红	F
吴柏林	M
孔佳男	F
曹玉柱	M
赵小娅	F
万国辉	M
胡细红	F
李美茹	F
滕艳	F
邬林云	M
张利娟	F
马颖	F
姚红伟	M
张倩	F
彭克谦	M
衡雪彩	F
张小丽	F
赵明	M
陈亮	M
李凤涛	M
高勇	M
龚运红	F
张术勇	M
温世阳	M
伍海龙	M
陈艳	F
蒋娟娟	F
易启长	M
杨爽	M
支秋英	F
崔雪	F
孙超产	M
齐正香	F
钱婧	F
王宽	M
梁建	M
叶金挺	M
沈荣乐	M
张俊斌	M
林海波	M
章妙德	M
张艳	F
程伟	M
戴坤鹏	M
周军领	M
谭美灵	F
王颖	F
盛杰	M
李志强	M
姚杰	M
王珺	F
王延	M
方齐赞	M
伊田力	M
赵丽丹	F
洪益	M
程飞强	M
宁飞	M
刘年珍	F
闫治强	M
章妙祥	M
吁文平	M
袁春亮	M
赵上淦	F
董秋燕	F
张侠	F
韩宝东	M
唐涛	M
苟升平	M
魏厚程	M
李新星	M
李文若	F
阳隆信	M
俞立红	F
孙臣见	M
张天涛	M
沈玉芬	F
叶燕君	F
梁文晖	M
李梦	F
郑明平	F
张守来	M
肖秀	F
姚真真	F
吴小飞	M
陈东	M
言平平	M
陈平德	M
熊章俊	M
王超	M
鲁雪燕	F
王建英	F
邓姣姣	F
戚益和	M
宋德城	M
丁雨	M
杜兰	F
张修云	F
刘增	M
胡林	M
姬小帅	M
童贻兵	M
张丽云	F
宋佳	F
孙凯	M
任夫洪	M
尹路路	F
唐双双	F
余月华	M
刘君火	M
何泽存	M
陆缙龙	M
章裕	M
尚礼云	M
章琦	M
张雅静	F
方承丽	F
任星	M
蒋素平	F
余金枝	F
贝学东	M
周晓龙	M
刘乐	M
马要东	M
赵云	M
罗霜阳	F
魏华	M
鄢友建	M
孙西江	M
朱凯磊	M
卞新鹏	M
刘奎	M
刘爱琳	F
陈驱午	M
张坤鹏	M
官旭明	M
覃鹏	M
刘新颖	F
陈德贵	M
曾传芬	F
付苹	F
郑保成	M
王双英	F
熊海平	M
孙加欣	M
许庆宝	M
宁亚婧	F
王晓燕	F
刘朝斌	M
赵建勋	M
贾军霞	F
陈雯	F
张琪	F
喻跃兵	M
周强	M
苏露湘	F
高刚振	M
钱江华	M
贾龙	M
楚晓星	M
蒋秋香	F
闻科	M
邹峰	M
蔡文清	M
温之胜	M
胡银龙	M
熊奥迪	M
吴莉伶	F
叶小兰	F
杜乃刚	M
曾国虎	M
王晓平	M
罗哲华	M
张超	M
姚盼盼	F
赖益佳	F
叶笑	F
童波	M
王娜	F
曹群祥	M
王晓丽	F
彭亚梅	F
郭秀英	F
刘栋良	M
李杰	M
徐翔	M
杨华芝	F
王清美	M
龚少红	M
王飞	M
李敦继	M
宁莹华	M
李仁侠	F
许善燕	F
洪涛	M
张金凤	F
周志祥	M
杨永梅	F
顾小平	F
吴维辉	F
何银辉	M
刘虹艳	F
卢邦丹	F
李瑞龙	M
陶敏	M
王宝立	M
查兴荣	M
蒋文武	M
李韦	M
张璐	F
魏新环	F
汤阳飞	F
严晶慧	F
张志伟	M
周挺	M
端丽	F
马俊杰	M
孟庆梅	F
童赳健	M
郑涵	F
万秋平	F
雷蓉光	F
李孝忠	M
盛洁	F
方灿	F
邹海权	M
柴娜丽	F
陈晚秋	F
陈容	F
刘张琼	F
熊岩	M
杨建	M
朱学翠	F
曹孝员	F
刘涛	M
王海平	M
刘海燕	F
李淑华	F
冯枚英	F
陈全辉	M
王宁	F
张士黎	F
任艺璇	F
曲涛	M
穆美婷	F
贺卫国	M
张翔	M
俞琴芬	F
熊小菊	F
张艳慧	F
袁虎	M
刘丽玲	F
林强	M
卓少云	M
沈阳	M
谈礼桂	M
熊晓峰	M
田海莲	F
张书帝	M
王媛媛	F
韩淑芳	F
夏冬	M
叶爱凤	F
缪招盛	M
孙广旭	M
张静	F
焦义凤	F
祁立新	M
张维新	M
吕同宵	M
罗会斌	M
任浩磊	M
周佳	F
陈明侠	M
杨海涛	M
段骏飞	M
俞宏杰	M
柏玉东	F
李博凯	M
邢东兴	M
李雪	F
周忠林	F
孙宝荣	F
杨祥凤	F
赵湖海	M
郑莉兵	M
卢超群	M
张大运	M
曾正兴	M
丁梅花	F
何文春	F
甘永健	M
王仓米	M
张丽容	F
刘欣	M
赵群	F
李聪	M
黄小珍	F
张峰	M
罗莉香	F
张迁迁	M
李洋	M
张勇	M
王向利	F
唐仁菊	F
范林清	M
张佳敏	F
王生桂	F
叶克帅	M
周伟	M
张梦琴	F
姜静	F
蓝龙川	M
蒋益辉	M
操程程	M
周亮亮	F
徐齐放	F
谭修辉	M
蔡文侠	F
张圆圆2	F
唐鹏	M
李传杰	M
陈明裕	M
罗维权	M
王慧妮	F
俞志根	M
熊海枟	F
李春玲	F
漆小华	F
邹家伟	M
王子洋	M
徐强	M
张凤英	F
马伟军	M
张春	M
马小孩	M
潜梦娇	F
宋亚军	M
吴春平	F
成杰	M
项丽丽	F
周敏	M
罗德义	M
王雪明	M
沈志伟	M
浣芳	F
刘晓庆	F
高唯	M
祖燕	F
许锡忠	M
王齐飞	M
李兴平	F
杨琴	F
陈梅仙	F
孟莉	F
马汝华	M
喻连	F
金慧芹	F
胡支鹏	M
刘波	M
王玲	F
栾绍琪	M
刘明	M
廖杰晶	F
张彦彦	F
宁秀红	F
任秀兰	F
张志强	M
董健	M
宁小兴	M
高江	M
郭建党	M
罗霞	F
陶吉	M
杨洋	M
郭印存	M
王桥红	M
曹峰	M
李新国	M
王敏	F
叶辉	F
刘文欣	F
徐亚飒	F
刘楷	M
储节龙	M
何江	M
韩丽英	F
谭盾	M
程文豪	M
赵凡	M
郭志清	M
王贵林	M
凌倩	F
李小宝	F
杨凤玲	F
徐煜	M
尹常旭	M
张鹏飞	M
武红发	M
田美美	F
顾欣羽	M
祝天云	M
邓杨玲	F
庞才荣	M
陈刚洋	M
刘孝兵	M
周凌元	F
张才南	M
毛海英	F
应必金	M
蒲碧全	F
段嘉宇	M
伍慧	F
侯正伟	M
史亭亭	F
贺忠敬	F
张文江	M
金旭	F
胡修仁	M
李春华	F
赵昌明	M
黄幼成	M
叶孟杰	M
覃承燕	M
唐俊	M
吴亮亮	M
王春杰	M
沈胜一	M
唐春儿	F
郑珠	F
叶孟杰	M
叶继多	M
陈伟明	M
阮全通	M
王辉	M
洪建达	M
王孝意	F
李凌宏	M
徐金伟	M
韩孟华	M
任登	M
吴意芳	F
贺婷婷	F
朱其龙	M
戴伶伶	F
吴锡意	F
何斌	M
熊毅	M
孟凡成	M
王红来	M
王志红	F
程洪永	M
潘宝根	M
夏忠兰	F
江兵	M
裴升光	M
朱雪芳	F
陈宏武	M
刘白岳	M
刘成	M
王春香	F
沈国荣	M
陈其敏	M
张领仙	F
马成军	M
陈秋生	M
王长海	M
汪木凤	F
李林炯	M
袁义	M
周少平	M
黄瑶瑶	F
陈雪英	F
吴建明	M
彭耀辉	M
冉华英	F
戴春茂	M
孙凤琴	F
叶亚素	F
袁立辉	M
章明霞	F
李见迎	M
汪志	F
陈华平	M
彭德	M
崔朝峰	M
黄云飞	M
吴谊涛	M
汪建	M
李群	F
熊海明	M
郑露	M
吴爱珍	F
冯耀华	M
王国荣	M
张建江	M
陈萍	F
罗佑华	M
黄淑琼	F
李齐超	M
杨文娟	F
王寿荣	M
郑春艳	F
周才榜	M
阙卫	M
汪伟	M
徐芹菊	F
张耀东	M
饶志文	M
张成夫	M
李立锋	M
许照海	M
王宏杰	M
褚红军	M
韩晓琴	F
虞亚君	M
杨万绪	M
张怀川	M
陈威	M
梁飚	M
凌长菊	F
林修印	M
郑忠	M
徐田	M
韦雪华	F
黄新伟	M
李纪丰	M
李振鹏	M
陈丽娟	F
丁宝姝	F
易刚海	M
何鑫	M
张茂桐	M
冉缠缠	M
訾阳	M
陈康鹏	M
涂聪聪	M
余美玲	F
张文萍	F
刘小兵	M
郑蒙娜	F
张宇航	M
王学海	M
李国庆	M
李华	M
黄华	F
胡会原	M
徐丹静	F
王又佳	F
张鲁挺	M
李晨晨	M
邹珍	F
张铁忠	M
杨连磊	M
张志奔	M
阳浩然	M
周海芬	F
马冬花	F
王玉双	F
崔寿松	M
郑艳红	F
耿彦平	F
曾俊	M
王庆花	F
李培	F
王宗雷	M
李慧林	F
朱莉凤	F
朱森桂	M
李鑫	F
李明泉	M
薛一兰	F
熊晒香	F
张永强	M
李情海	M
邓佳斌	M
华蕾	F
曹国友	M
薛锋新	M
田博龙	M
何丹露	F
周毅保	M
安道煜	M
任俊芳	M
梁次英	F
陈虚	M
魏厚文	M
康晓峰	M
张森康	M
郝朝帅	M
梁勇	M
王叶	M
关全国	M
高静	F
李秀英	F
汪志明	M
张广玲	F
廖成文	M
魏祖群	F
高鹏利	M
黄国文	F
韦佳	F
文苏梅	F
黄秉杰	M
李俊芳	F
刘彦杰	F
张志山	M
姜晨	M
林婷婷	F
王行朝	M
马称乾	M
熊安啟	M
李志钢	M
熊公森	M
邓怡毛	M
应碧锋	M
李文霞	F
童元祖	M
杨世涛	M
董月雷	M
崔盛	F
徐清清	F
叶枫叶	F
胡佳丽	F
苏春安	M
左浮印	M
王小曼	F
石秀云	F
李辉龙	M
蔡志恒	M
任晶晶	F
雷伟峰	M
张春丽	F
曾航	F
徐晓东	M
吴燕君	F
陈春平	M
邵亦涵	M
高仙仙	F
龚如霞	F
杨莲英	F
李甜甜	F
戴中平	F
侯亚飞	M
陆甬波	F
孙令权	M
丁飞强	M
王旭锋	M
徐方琴	M
梁鑫	M
贺佳佳	F
蒋发军	M
彭春秀	F
陈蕾	F
杜棉恩	M
吴先涛	M
钟云鹏	M
郑锦涛	M
江金强	M
罗卫华	M
覃东	M
李停停	F
刘夤	F
王丽莲	F
赵艳梅	F
方立文	M
王航强	M
熊垒	M
张燕妮	F
郭文青	M
钱欢	F
瞿宁辉	F
陈翠兰	F
陈佳艳	F
潘何英	F
程龙	M
周文静	F
郑春环	F
黄慧1	F
李阳	M
郑万佑	M
陈超	M
韩艺	F
徐华明	M
熊向莉	F
纪智强	M
兰杨	M
冯敏	M
王亚君	F
李文祥	M
黄方平	M
宁芬	F
万菊	F
江雪卫	F
徐金燕	F
李春纪	M
马明标	M
王强强	M
尤文革	M
毛友蓬	M
熊南海	M
姚亚均	M
戴红英	F
周婷婷	F
杨世京	M
谢勇安	M
江君	M
吴军伟	M
吕萌	F
高向红	F
杨启贵	M
刘铁华	M
李玲	F
魏晓	F
刘雪松	M
禹琰	M
张含春	M
甘绪国	M
俞建梅	F
罗红妹	F
陈炳吉	M
邬国陆	M
陈娜	F
范刘红	F
叶开林	M
山峰	M
钟招庆	M
许国倩	M
董婷婷	F
危芳琴	F
张凡	M
古汤汤	M
付瑞爽	F
吴玉枝	F
谢桂兰	F
李文学	M
李茜	M
刘招林	M
吴富刚	M
周阿微	F
潘建斌	M
彭白华	M
徐莎莎	F
杨茂	F
周玉	F
盛立锋	M
杨小亮	M
余小琴	F
曾柏权	M
单英飞	M
李育涛	M
王绍伟	M
王杭挺	M
吴晓辉	M
缪颖儿	F
戚长根	M
张亚红	F
陈平龙	M
李治兵	M
王静	F
陈旭	M
周明军	M
王艳	F
李小梅	F
陶玉花	F
王珊珊	F
甘春英	F
李梅梅	F
夏三花	F
况绍刚	M
王海琴	F
黄兰	F
康元术	M
吴美容	F
吴镓伟	M
崔红志	M
黄周铭	M
胡浩	M
张宏杰	M
王宝	M
陈森柏	M
吴明祥	M
王兴勇	M
李秋生	M
徐贤仲	M
高露露	F
魏家斌	M
王明显	M
张德志	M
蒲晓利	F
王永贵	M
金根花	F
李陆峰	M
赵桂凤	F
谢干江	M
钟银国	M
顾丽菁	F
沈仁福	M
王玉梅	F
孟凤霞	F
王爱霞	F
成小飞	M
李伟	M
李鸣	M
张怡	F
应奇峰	M
龚和亚	F
黄燕	F
傅新苗	F
何兰兰	F
曹书英	F
苏云艳	F
单喜丰	M
顾微微	F
房素琼	F
吴云良	M
王昭军	M
胡丹	F
钱秋亚	F
李林锋	M
干小波	F
王国明	M
张明海	M
陈纪根	M
范敏	F
汤家安	M
潘一波	M
胡良马	M
徐嘉颖	F
王敏飞	F
赵行淑	F
方晓华	F
陈行君	M
唐雪琴	F
陈孟岳	M
王式坦	M
彭付仁	M
冉华国	M
杨星星	M
许军民	M
胡亚东	M
徐嘉永	M
陈洪波	M
程臣	M
周微平	F
吕黄河	M
崔轩	M
刘晓燕	F
姜芬芳	F
奉永英	F
胡莲花	F
何剑先	M
崔建丰	M
邹波	M
钟瑞国	M
吴国民	M
周平中	M
刘代歆	M
沈永良	M
胡立	M
王海芬	F
程华明	M
陈李丽	F
张怀苹	F
陈红波	F
姚其东	M
叶桂大	M
邵培波	F
李素芬	F
钟亚波	F
刘甲	M
李方平	M
柴科丹	F
何新颍	M
陈明芬	F
向先平	F
陈亚波	F
王均飞	F
江善忠	M
谢成富	M
易琴	F
徐翠	F
吴高峰	M
严位娟	F
陈树兰	F
黄巧云	F
张小燕	F
何识财	M
刘小光	M
章玉娟	F
邹丽	F
陈锡光	M
何飞雄	M
殷瑾	F
陶东升	M
陈柯娜	F
周希林	M
朱伊杰	M
黄朝霞	F
李东东	F
张彩芹	F
石鑫	F
陈瑶	F
李娜	F
金贤松	M
金贤强	M
涂小凌	F
李小雪	F
李记	M
周云强	M
王清亮	M
刘二江	M
张文好	M
吴大芝	F
艾丽娜	F
韩瑛瑛	F
修媛媛	F
张良爱	M
纪海平	F
毛宁	M
靳金	F
何家涛	M
郭爱霞	F
李洁	F
付南	M
张潮	M
杨佳霖	M
杨继华	F
毛会民	M
刘科	M
王洪春	M
张金娥	F
陆洪军	M
张伟	F
杨刘东	M
楼金婉	F
李瑞全	M
王雪艳	F
石雅辉	F
李海军	M
戴燕真	F
张欢	F
彭听听	M
余龙	M
李君	M
张和梅	F
从宏禧	M
邹娇娇	F
游小花	F
崔洪敏	F
许扬	M
马芳	F
孙飞	M
兰江	M
陈聪	M
张伟	F
于莹莹	F
张永瑞	M
石紫君	F
李财云	M
翟二春	M
胡效良	M
罗斌	M
樊冰冰	M
陶光安	M
谢启站	M
严凯	M
李国丽	M
张坤	M
马启招	M
万珍珍	F
宋欣	F
王大芳	F
戚迎东	M
陈丽	F
张海立	M
周凤玲	F
吴小添	M
严信锋	M
董其友	M
余浩	M
王伟超	M
黄正兰	F
周繁优	F
付会欣	F
李明宇	M
袁江华	F
潘少琪	M
王立冬	M
郝鹏飞	M
赵蝉	M
宋祖信	M
廖野兰	F
郑莎莎	F
冷晓刚	M
康洪建	M
李巧灵	F
徐绍奋	M
王洁	F
刘万寿	M
凌琴	F
张刚	M
陈彦	M
周雄	M
艾忠义	M
罗登亮	M
余尖兵	M
黄勇清	M
张晓晓	M
张向阳	M
张利	M
陈舒	M
胡新军	M
朱金山	M
童悦	F
汤涵晶	F
张芳	F
杨志彬	M
陈雅娜	F
陶明花	F
荆传军	M
崔敏	F
涂大菊	F
张东磊	M
贾红梅	F
王锋	M
张建华	F
储召琴	F
刘飞	M
吴霞	F
刘双虎	M
陈霞	F
谈年华	M
高东	M
刘祥朝	M
陈美满	M
赵晋强	M
郭金震	M
竺兴迪	M
谢远超	F
赵红梅	F
云梦雨	F
李志华	M
林炀栋	M
林嘉迎	F
周天云	M
金应富	M
凡朋朋	M
彭小英	F
周彩侠	F
魏胜利	M
翟翠	F
朱玉霞	F
王晖	M
余梦蓓	F
陈云	F
朱南	F
刘大水	M
杨锴	M
黄绍骏	M
张明强	M
方红见	M
余贱根	M
刘宇航	M
贺党霞	F
原惠惠	F
刘瑞雪	F
熊刚	M
黄榕	F
万晓梅	F
张伟	M
王海香	F
董夏	M
李秀帅	M
杨帆	M
李文旗	M
唐林	M
俞秋芳	F
胡航宇	M
陶郑	M
涂恒	M
王海霞	F
何鸥鸿	M
郑矫璐	F
崔然	M
何婉婷	F
杨泽成	M
谷广辉	M
陈金花	F
邹绵强	M
薛德顺	M
史蓉媚	F
许睿雯	F
孔祥义	M
孙锋烽	F
庞亚朋	F
张丹丹	F
李林	M
黄姗	F
王伟	M
陈水根	M
姚超	M
张杰	F
姚旭红	F
韦小利	F
林敏	F
王紫媛	F
郑小芬	F
朱项婕	F
方辰莉	F
王菲	F
徐园明	M
陈武金	M
陈惠	F
杨鸿展	M
游水清	M
单聖钧	M
舒贵林	M
宋家宸	M
尚泽凯	M
王凯宣	M
黄茹梅	F
吕倩	F
史艳增	M
杨宇双	F
周鑫	M
史娜	F
李天	F
应杉杉	F
陈虹	F
俞秀铃	F
杨琳丽	F
惠飘飘	F
王芳	F
周斌	M
尚凯锋	M
赵一心	M
谢伟康	M
李志刚	M
王光明	M
王友金	M
徐秀	F
王建丰	M
梁凤玲	F
孙溪童	F
吴翟	M
郑炳娴	F
侯丽丽	F
裘松燕	F
王旭英	F
申可	M
池依依	F
姜少东	M
杨洪芳	F
邵童	F
张佳伟	M
卢宇锋	M
付云	M
杨猛	M
欧阳思凡	M
陶愧愧	M
乔洁	F
李斌	M
夏江亭	F
马兰花	F
龙荷花	F
张海亮	M
卢亮	M
林莲	F
喻智明	M
李炳权	M
周洪罡	M
邹绵刚	M
龚佩珞	F
张开辉	M
沈桑桑	F
严佳	M
代安付	M
温祖凤	F
陈浩强	M
赖秋玲	F
邢迪	M
王慧芬	F
朱丽姣	F
陈文亭	M
赵峰	M
邓博	M
钱鹏	M
金凯辉	M
谭定刚	M
王加银	M
许逸霏	F
周倩	F
魏新福	M
郑波峰	M
周小英	F
闫娟	F
黄海琴	F
张莎莎	F
毛花艳	F
王昌斌	M
王子富	M
李松	M
汤品友	M
余挺	M
蔡铖	M
钱益	M
李莉	F
李金诚	M
顾增光	M
周志贵	M
朱晓莉	F
谢程莹	F
刘少贝	M
周衡	F
刘斌	M
张人玉	M
王凡	M
何秋香	F
孙东艳	M
戎弋婕	F
张晓晓	F
褚明杰	M
黄筒然	F
刘廷文	M
邱婷	F
阮佳辉	M
张小兵	M
汪飞	M
亢利华	M
徐晶	M
熊师强	M
朱小女	F
张宁	F
丁传宝	M
尚路路	M
朱蕾蕾	F
张志民	M
高嫄	F
许娟	F
张建	M
张为让	M
黄红凯	M
唐文	M
胡文强	M
杨伟	M
郭雨蒙	M
柳会勇	M
余润	M
王庆辉	M
叶滋龙	M
肖传东	M
张强	F
王立平	F
郭静	F
沈华东	M
张莉	F
王梦璇	F
陈丽兰	F
田公磊	M
曾秋华	F
杜春红	F
尤丽丽	F
李迎滨	M
罗崇	F
张雷	M
刘宝萍	F
郭正杰	M
孔桂英	F
徐兰兰	F
任婷	F
刘天朗	M
郑思明	M
闻静	F
雷星	F
张清理	M
王飞凤	F
程伯通	M
曹筱璐	F
张玉花	F
齐书变	F
罗荣庆	F
秦建杰	M
高习艳	F
姚骏	M
曾建荣	M
张晓涛	M
张连洁	M
王蕾	F
何平	M
熊连兰	F
刘俊学	M
蔡必开	M
杨丹	F
陶燕	F
邓启超	M
宋书勤	M
计鑫	F
王美聪	F
侯兴吉	M
蒋元春	F
王福来	M
徐志英	M
林殊姿	F
邓海吉车	F
许战	F
万常青	M
景江	M
李春辉	M
刘更新	M
杨理奎	M
豆晓瑞	F
熊沙沙	F
郑玉龙	M
曲丹	F
王秋英	F
张池亮	M
韩永彬	M
翁锡金	M
王智慧	M
李政	M
缪波	M
吴跃	F
郭士宇	M
赵和新	M
章少林	F
史亚超	M
施霞	F
田凤	F
夏丽平	F
凡亚平	F
秦君	M
袁双全	M
兰九连	F
李月	F
张云	F
郭培松	M
杨桂芝	F
邓红亮	M
梁晓宇	F
王田田	F
向文海	M
周文佩	M
黄文美	F
范瑞珍	F
李国莲	F
王传玲	F
钟立	M
张雪梅	F
郑杰	M
任静	F
丁彩莉	F
李红凯	M
蒋忠金	M
杨菊	F
吴欢	F
杨忠华	F
单伟民	M
冯特波	M
邓振武	M
陈玉丽	F
孙华金	F
周少华	F
熊义摇	M
罗群	F
陈锟	M
陈超	M
杜军	M
王芬	F
覃学思	F
涂晓建	M
乔飞	M
董玉勤	F
陆跃培	M
张迪	M
汪建林	M
李霞	F
徐意巧	F
张欢	F
王婕	F
李炳炳	M
颜素荣	M
熊清爱	M
罗成杰	M
陈静	F
曹汝霞	F
杨玉影	F
章林平	M
杨晓春	F
万杰	M
杨坚	F
费佳兰	F
凌象侠	M
徐锦坤	M
李芬	F
刘德兴	M
唐堤	M
潘红霞	F
万常明	M
王义昌	M
韩卫康	M
孙宝云	F
谢勇刚	M
戴克成	M
徐慧玲	F
李国印	M
刘星	M
沈利炎	F
祁彪	M
赵静文	F
姜彦博	F
孙静静	F
黄宗龄	F
舒海华	M
朱国高	M
马宝银	F
杨雪	F
王毅	M
刘倩茹	F
王丹妮	F
管满英	F
张永磊	M
严建益	M
许珊	F
邹香花	F
金娟	F
杨花群	F
马志寿	M
金亮	M
江润林	F
周清	F
游代文	F
李燕	F
郭维顺	M
吴晋华	M
冉蒙	M
张健	M
丁祖成	M
易志谋	M
戴刚劲	M
伍兆聪	M
王莹	F
黄伟元	M
赵攀	M
雷航	M
任宁凯	M
徐方龙	M
杨通华	M
何晓英	F
王仕帆	M
张昇	M
张静	F
陈晶	F
姜丽华	F
范雪琴	F
沈春贻	M
兰贞梅	F
刘庆娟	F
时加兵	M
蔡陈玲	F
周磊	M
李超	M
李小龙	M
齐雪文	M
孙亮	M
段得忠	M
彭三悟	M
熊积财	M
孙长虹	F
叶灵巧	F
贾超义	M
单丽丽	F
宋志华	M
徐家杰	M
熊志宏	F
王正香	F
吴洋	M
杨明登	M
孙品品	F
谢海平	M
陈威宇	M
黄浪	M
张芳	F
杨明友	M
李冰竹	F
戴凯	M
吕雅宁	F
肖兰	F
吴婧	F
曾乃利	M
叶宇峰	M
胡志华	M
覃有坤	F
申菲菲	M
林成凌	M
唐水其	M
陶建峰	M
孔宏	M
倪剑英	F
刘静	F
蒋丽娜	F
储王亮	M
陈忠延	F
熊糠	M
汤娟	F
李传体	M
张聚	M
罗来玉	F
任争光	M
李继峰	M
徐慧琴	F
王尾香	F
刘玖瑰	F
张彦文	F
张海玲	F
高强	M
周裕	M
杨维杰	M
刘晶声	M
赖银国	M
陈芳芳	F
孙玲雯	F
祝建议	M
章丽	F
杨波	M
张小变	F
何志明	M
洪达雨	M
袁强	M
邓菊红	F
吴来保	M
张魁敏	M
金仁铅	M
张美	F
高敏	F
王君清	F
裴东	M
龚兵	M
安正周	M
傅琦亚	F
雷小小	F
张丽	F
刘红梅	F
吴天成	M
黄志强	M
吕文彪	M
陈欢	F
肖勇	M
李兰英	F
杨妮	F
王少哲	M
牛庆利	F
赵兴	M
喻根花	F
金海荣	M
杨洁	F
马新欣	F
鲁水婷	F
励立	M
程美花	F
柴亚伟	M
申海纳	F
曹海燕	F
袁国正	M
方娇娇	F
陈亚飞	F
王莉	F
汪静	F
邹敏敏	F
王帅	M
沈文斌	M
梁兴平	M
杨磊	M
付丽玲	F
马志伟	M
杨淑兰	F
卓佳	F
胡才家	M
王幸幸	M
王建强	M
刘凯圣	M
梅有泉	M
魏凌沅	M
赵亚兵	M
景少峰	M
施展	M
刘井胜	M
熊照	M
申丹丹	F
柯思蒙	F
欧阳勇恒	M
于彩娟	F
王汝力	M
刘花	F
刘超	M
涂娜	F
屈兴强	M
苏言停	M
黄德志	M
吕爱君	F
张静	F
郭良良	M
王志敏	M
姚夏琪	M
陈永军	M
夏贤强	M
吕运玲	F
梁婷婷	F
李道娟	F
吴江宁	F
杨羽霖	F
胡飞	M
刘兰兰	F
程年花	F
王信航	M
马凯	M
李绿芸	F
刘洪国	M
李荣晓	M
崔玉鳌	M
李丽宏	F
刘桂荷	F
郑丰	F
刘金华	F
杨巧云	F
夏兰花	F
夏韶兵	M
王前飞	M
郑素萍	F
支湾英	F
蒋杨星	M
吕勇智	M
雷跃进	M
陈芳宏	M
陈文俊	F
王震	M
李华军	M
聂戈婷	F
张连强	M
范浩斌	M
石玉海	M
周浩	M
丁进	M
张奇斌	M
徐其聪	M
韩祥	M
张细	F
罗海云	F
黄辉	M
姚孝东	M
沈其荣	M
陈晨	M
任中康	M
王玉凯	M
高燕坤	M
徐茂	M
曾正勇	M
杨超	F
唐楠	F
代瑞琼	F
明红群	F
高建民	M
陈娟	F
张萍	F
王孟江	M
王梅	F
朱俊杰	M
黄鹏	M
吴继青	M
史兆伟	M
张秀桂	F
沃佳雯	F
彭风妹	F
宛汉龙	M
林波	F
刘爱军	M
魏保香	M
袁丽艳	F
张水平	F
孙宝波	M
张威名	M
倪捷	M
陈桥	M
郑胤颖	F
胡昌浪	M
臧前伟	M
唐海波	M
林益双	M
杨宜俊	M
陈刚	M
杨吉昆	M
王永勋	M
陈明君	M
李金兵	M
程茂武	M
刘伟欢	M
杨青	F
黄小弟	M
张霞	F
董航	M
谢程	F
梁祝英	F
来鸣	F
胡清波	M
袁峰	M
许瑞银	M
郝进峰	M
李大川	M
张雷	M
程莉	F
陈红玲	F
吕晶晶	F
李韶	M
周露露	M
刘文彪	M
王雪琴	F
刘升	M
陈黛	F
沈启虹	F
朱峻峰	M
严婷	F
王水亮	M
熊宇坤	M
王成伟	M
万小妹	F
饶强	M
王龙	M
郝秀平	F
王巍	F
俞月娇	F
王伟	M
戴东伟	M
程娟娟	F
俞军国	M
孙莹	F
严财灿	M
张飞	M
蔡瑞侠	F
王新刚	M
徐丹	F
方有华	M
杨银燕	F
陈玙璠	F
倪龙飞	F
苗盼盼	F
李文亮	M
赵庆娥	F
熊菊玲	F
李玉香	F
王伟明	M
万拉拉	F
王雷	M
饶建明	M
李雪超	M
毛翔	M
杨兴	M
黄勇安	M
张艳伟	M
马东宁	M
张松	M
代总红	F
权彭波	M
韩剑超	M
张伟	M
徐啟华	M
熊世强	M
严熙银	F
黄华楠	M
赖建仕	M
张誉天	M
冯建峰	M
沈连杰	M
李伙	M
卢汪明	M
秦雪勤	F
伍唯唯	M
王海花	F
陈湘勇	M
霍晓炜	F
吴秋实	M
付晶晶	F
孟云花	F
吕志侠	F
李文航	M
赵倩文	F
李明杰	M
吴坤	F
张少辉	M
周燕	F
李荷花	F
张标	M
何小华	F
鲁艳红	F
朱明刚	M
李英	F
罗词顺	M
张广根	M
杨琼英	F
张启福	M
俞令辉	M
丁满琴	F
严浩	M
何松	M
廖依玲	F
陈芳	F
章红烁	F
王佐佐	M
傅克衔	M
肖继程	M
张二涛	M
陈黎源	M
王琴	F
闫红宇	F
邓颖	M
杨琼琼	F
李芳芳	F
古学红	M
廖小强	M
张丽	F
赵小兵	M
陈恩莲	F
王庆	M
吕蓉蓉	F
严婷	F
柴世强	M
刘亚芬	F
张海昌	M
温海涛	M
喻淑静	F
麻尤奴斯	M
邹乾进	M
徐兰英	F
彭颖	F
张武明	M
邵宇翔	M
周保川	M
万奇奇	F
万辽斌	M
田官河	M
雷根妹	F
熊强强	M
代碧香	F
严信安	M
张璐	F
陈军	M
胡杰	M
熊连连	F
王琨	M
谭杨杨	M
夏桃根	M
胡华政	M
王振韬	M
马洒力哈	M
陈泽	M
饶秋华	F
邱开俊	M
吴光勇	M
汤小东	M
胡可	M
陈超	M
郑捍东	M
任春雨	M
杨文飞	F
杨海福	M
王树权	M
林尼	F
李长军	M
禹少平	M
冯晶晶	F
尹国伟	M
秦维伟	M
周少华2	M
沙占虎	M
张娜	F
朱凯杰	M
张承涛	M
吴科君	M
徐丽	F
智国奇	M
赵银萍	F
程倪	M
杜兴国	M
谭苗苗	F
王炜	M
童勇	M
庞文辉	F
姚在新	M
丁洁	F
张思猛	M
尹赛琼	F
王凯明	M
李家良	M
杨建光	M
郑波	M
王微微	F
刘兰英	F
宋建丽	F
金宁群	F
夏生	M
董春彤	F
李岩森	M
陈乐	M
俞飞跃	F
王华兵	M
徐逵仕	M
卢高	M
熊靖	F
李天霞	F
熊青青	F
邬昕韵	F
吴希铭	M
凌象雨	M
何少俊	M
周媛媛	F
厉光耀	M
毛芳苍	M
牛俊鹏	M
马国栋	M
滕玉莹	F
苏阳斌	M
王宇	M
罗碧山	M
杨波	M
张金岭	M
刘红兵	F
陈莹1	F
徐超	M
崔康	M
饶代君	M
米哲	M
吴志雪	M
刘松	M
戚振群	M
杨秋远	M
李立飞	M
蒋洪波	M
陶学秀	F
钱惠萍	F
王建国	M
苏玲艳	F
孙颖	F
彭帮森	M
张昭祥	M
董华建	M
张海生	M
周振	M
张桃	F
晏强	M
胡犬华	M
虞乔志	M
周丽	F
徐金晶	F
刘新	M
张瑞贤	F
王薇林	F
阳志超	M
王启阔	M
马学兰	F
刘黎	M
李海峰	M
唐宣民	M
王少文	M
庹召宜	F
方秀兰	F
章张浩	M
李小环	M
丁淑琴	F
杨志宝	M
张保柱	M
刘志凯	M
李盟洋	M
马振领	M
孙杰	M
高宏伟	F
徐红娟	F
陈可	M
董盼狄	M
严福友	M
熊海	M
王路瑶	F
阳大建	M
周春兰	F
宇冉冉	F
李晋凯	M
张璐波	F
陈金明	M
云梦龙	M
冯达	M
廖刘园	F
李杨	M
王凯	M
王世博	M
申文韬	M
任绍宝	M
朱珍珍	M
张杰	M
张建宇	M
庄玉东	M
闵敏	M
文丽丽	F
张玉军	M
罗镇维	M
刘博通	M
谢同	M
刘佳	M
单川波	M
赵胤	M
李武省	M
吕强	M
陆小琴	F
沈秋平	F
赵刚	M
万晓红	M
潘冬华	F
李君	M
冯彩云	F
吕珂莹	F
徐福路	M
刘贵清	M
陈艺博	M
李妮	F
刘昭锋	M
李继明	M
马小勇	M
董佳丽	F
师立东	M
李福帅	M
张勇	M
杨天帅	M
刘林	M
卓幽静	F
郑成云	M
励楠	F
王慢慢	F
魏艳华	F
胡昌海	M
庞明昆	M
李云	F
曾庆壮	M
周国香	F
肖聪勇	M
王燕儿	F
熊志强	M
郑军	M
张小林	F
孙竞楠	F
陈小虎	M
蒙四红	M
胡掌文	M
闫利利	F
陈伟	M
罗玉兰	F
蒋云	M
涂序明	M
陈鹏	M
黄霞	F
黄勇	M
杨凯	M
钱建强	M
胡湘民	M
胡革民	M
潘家琰	F
张让	M
刘翠华	F
邓亭	F
刘正勇	M
王凤刚	M
胡伟	M
周静	F
郑芹	F
黄冬梅	F
兰卫红	F
熊凯	M
朱慧	F
刘燕波	M
孟国印	M
尚诗瑞	F
徐红亚	F
高炎超	M
王青青	F
段喜森	M
黄康前	M
彭保生	M
石立新	M
汤昌余	M
邢飞燕	F
马季	M
陈希希	F
关蒙	F
连蕉香	F
章聪聪	F
何龙水	M
韩文文	F
李文龙	M
温德威	M
傅细平	M
唐仁平	M
谢瀚毅	M
张小兰	F
沈赛丽	F
吴卫根	M
褚振英	F
胡馨	F
褚智慧	F
袁祖莉	F
张英	F
马颖	F
杨奇奇	M
卢苏鹰	F
徐健红	F
陈圣杰	M
王辉兰	F
韩福众	M
胡永和	M
马君	M
卢虹君	M
余忠伟	M
金昱含	F
郑宇	M
郝正成	M
刘兴龙	M
韩旭	M
王雪姣	F
蒋晓龙	M
江建柳	M
俞佳位	M
汪梦婷	F
赵倩	F
陈惠文	F
袁帅	F
刘福安	M
赵园园	F
刘成飞	M
杨青青	F
邹源军	M
熊道仁	M
马玉姣	F
冯珊	F
吕尊尊	F
曹启锋	M
马骥	M
毛文强	M
邢爱霞	F
曹馨月	F
李康英	F
吴桂荣	F
潘中祥	M
王聪	M
李孟月	F
张志勇	M
黄松	M
周宇峰	M
刘汝欣	F
王峰	M
荣朋	M
姜萍	F
李漫华	M
邓江郴	M
王明	M
王彪	M
邹胜金	M
余雯	F
黎心亮	M
刘铁江	M
开光辉	M
王文宗	M
李耀辉	M
邓君	F
汪敏强	M
孙海迪	F
杨芳	F
白定成	M
王守英	F
段文强	M
龚晓慧	F
张凤杰	F
刘潮	M
王春平	M
朱云兰	F
陈晶	F
李保同	M
费翠萍	F
毕光全	M
万小龙	M
杨青林	F
张兰	F
娄本亮	M
吴辉	M
李南枝	F
余程程	M
严根如	M
杨路捷	M
万乔雨	F
刘娟	F
符小红	F
郭家彦	M
潘玉梅	F
吴静仲	M
周芳芳	F
李滨波	F
郭小龙	M
程模文	M
姚新洪	M
黄福真	F
刘占芮	F
张文海	M
石永彪	M
牛乃宝	M
陈照帆	F
周潮飞	F
黎弯弯	F
曹国想	M
王银松	M
蒲春光	M
王翠	F
张志华	M
丁媛媛	F
盛启菊	F
秦顺英	F
张涛涛	M
王晓兰	F
钱佳东	M
董媛	F
王叶林	F
余春现	M
郭静伟	M
甘新科	M
韩金昌	M
王方洁	F
童锋	M
张佳祥	M
罗小辉	M
韦美芳	F
闵露露	F
曹立彬	M
孟陈呈	M
廖小丽	F
汪小博	M
艾明发	M
应升华	M
李玉玉	F
顾丰荣	M
冯连忠	M
邹佳琪	M
刘斯慧	F
虎雪亮	M
陈亦嘉	F
何沉香	F
孟瑞瑞	F
赵大刚	M
李江威	M
吴晓春	F
冉松涛	M
刘卢秀	F
张明英	F
曹智鹏	M
姚亮	M
周建民	M
罗月	F
夏仙花	F
王鹏帅	M
陈月	F
郑利波	M
李川江	M
沈杨	M
朱为民	M
叶亚芳	F
邬益男	M
潘丽	F
黄梅娟	F
赵元绿	M
卢泽海	M
何川	M
关利平	F
孙益林	M
张丽萍	F
董磊	M
张杰	M
杨东林	M
罗卫	M
贾晓帅	F
张俊辉	M
李虎	M
喻松	M
徐伟	M
甘丽丽	F
糜娜芳	F
李建一	M
张和旭	M
冷栋	M
罗爱红	F
袁大鹏	M
涂秀花	F
范春秀	F
温龙莲	F
陶守冬	M
王志恒	M
高荣军	M
伍兆昆	M
程业春	M
焦露	F
景曾辉	M
曾清秀	F
饶红	F
蒋梦雅	F
冷取妈麻	F
常玉香	F
李依听	M
柳桥	M
石浩	M
瞿昊强	M
刘朝霞	F
王二栋	F
柳忠淮	M
朱霞霞	F
张艳芳	F
李录强	M
王梅	F
胡萍萍	F
黄普	M
鲍建达	M
李军泉	M
赵建松	M
刘先云	F
毛国安	M
王雪	F
文辉	M
余忠强	M
向欢生	M
刘超杰	M
徐秀秀	F
翁璐瑶	F
鲁培榕	M
周瑞清	M
兰巧仁	F
宋小龙	M
曹步云	M
郭伟伟	F
岳喜华	F
毛秋路	M
李泽丹	F
钱夏磊	F
兰国洪	M
陈永锋	M
强兵罗	M
彭德宁	M
贺宝林	M
王欣	M
刘长文	M
吴洲辉	M
陈金玲	M
闵美芳	F
潘辉	F
黄海丽	F
何萍萍	F
章璐	F
孙辰昊	M
马世军	M
许钢	M
杨芝燕	F
蒋楚楚	F
金雯彬	F
汪国军	M
史兆文	M
李芳芳	F
王丹丹	F
黄夏煜	M
但送来	M
王雨	M
郑建伟	M
崔阿迪	F
傅俊杰	M
何秋菊	F
胡碧蓉	F
王志清	M
孙自勤	F
王建平	F
万如意	F
彭翠翠	F
张冬辉	M
何海艇	M
雷玙	F
李颖	F
刘亚南	F
杨龙	M
陈红梅	F
郭久伟	M
章强	M
秦琼	M
张妞妞	F
任延安	M
胡永利	M
张高强	M
王生辉	M
陈亚琳	F
孙于博	M
杨爽	M
薛金锁	M
方舒	F
汪新洲	M
焦禾壮	M
刘洋	F
马杰	M
颜梦其	F
黄松斌	M
杨小华	F
卫丽红	F
李冰	F
唐胜强	M
张珊艺	F
张辉	M
谢长鹏	M
周帆	M
张耀昂	M
王杰	M
申洋阳	M
李琴	F
喻玉平	M
董莉莉	F
盛敏	M
员文龙	M
承成	M
张南	M
杨光飞	M
黄培安	M
吴子昂	M
张欢欢	F
张慧萍	F
陈一敏	F
陈晓燕	F
章桂兰	F
杨中敏	M
徐菊花	F
陈鹏	M
谭咏	M
裘娟娟	F
冯荷琴	F
郭菁	F
李世佳	F
邵幽幸	F
王战华	M
曾正宏	M
白莉莉	F
周月红	F
傅东伟	M
郭倩	F
叶红华	M
李东辉	M
吕涛	M
段琳琳	F
夏敏	F
许丽英	F
袁前	M
娄芳	F
侯坤帅	M
龚鹏鹏	M
马来亥买	F
刘义东	M
王苗苗	F
夏万友	M
李元兰	F
唐成旺	M
杨新利	M
张光起	M
孙显得	M
白雪珂	F
刘明星	F
单景媚	F
李飞	M
陈扬	M
秦配配	F
郑九可	M
姚国根	M
黄力宏	M
杨州	M
曹利祥	M
温尊燕	M
赵鸿鹏	M
朱国胜	M
王帆	M
耿杰	M
林云	F
陈锦献	M
郭彬	M
孙英	F
杨津津	F
朱慧琴	F
张俊	M
赵栓明	M
孙斌	M
刘锐	M
熊喜才	M
熊林	M
倪国珍	F
单江飞	M
孙佳瑜	M
高宇霆	F
杨榜	M
姜璐梅	F
林瑞康	M
支国辉	M
吴鹏飞	M
杨立莹	F
刘朝臣	M
殷春	M
刘资庆	M
徐楠楠	F
戴育恒	M
魏建梅	F
徐恩君	M
李在康	M
张琼爱	F
李朝兰	F
赵玉鑫	M
蒲兴华	M
田昊洋	M
熊志强	M
赵沛鑫	F
路洪祥	M
李腾	M
刘燕	F
许镇镇	M
张磊	M
张小峰	M
李翔	M
陈疆	M
葛江东	M
海霞	F
蒋哲萍	F
杨海英	F
吴晓飞	M
王芙蓉	F
林浩	M
陈雪倩	F
程艳华	F
程新娥	F
陶小晨	M
吴君	M
吴梦林	F
汪旺	M
王凯	M
刘爱华	F
罗敏2	F
金凤	F
于春玲	F
徐卫辉	F
黄望	M
董小峰	M
郑晓艳	F
胡先勇	M
鲁志平	F
揭宇娇	F
周彧舰	M
胡利芳	F
刘复鑫	M
董周	M
徐江勇	M
汪旭灵	F
李青	M
刘勇	M
熊运兵	M
刘道清	M
刘晓云	F
汪美星	F
吴百明	M
张七四	M
赵潇栋	M
张得全	M
李丹丹1	F
卢爱琴	F
舒惠娟	F
刘凤鹃	F
周荣	F
董炎	M
朱朋飞	M
陈振华	M
王海峰	M
邵莉	F
杨兵	M
徐晓娟	F
王成璨	M
付长龙	M
杨路	M
吴金欢	F
罗应瑶	M
周丹迪	F
徐成银	F
曹远平	M
王圣杰	M
赖小勇	M
姚慧敏	F
丁琴	F
杨建波	M
章正威	M
周虹	F
吴琪林	F
刘林慧	F
李能飞	M
涂海罗	M
朱哲文	M
胡海华	M
薛璟	F
张丽	F
张诗雨	F
刘晓帅	M
张洋	M
李乔玉	F
彭冬妹	F
杜文超	M
姚述阳	M
左睿琪	F
杨丽娟	F
赵虹宇	M
陶军	M
温静	F
丁茂倩	F
祁祺	F
妥振华	M
马晓龙	M
程敏	F
鲍荣华	M
黄燕娜	F
曾庆豫	M
王培	M
沐秀华	F
郭盈盈	F
张桃燕	F
王博	M
刘宏智	M
虞文武	F
于大为	M
高城彬	M
陈璐	F
熊辉	M
万萍	F
胡铭杰	M
陈思琦	M
林柱	M
苏升卫	M
胡秉衡	M
王波	M
梁俊	M
王文涛	M
王杰	M
郭海光	M
吴承强	M
时涛	M
江远辉	M
曹施思	F
张恒	M
郭磊	M
王云	F
吴卫永	M
马玉兰	F
余敏	M
邓志勇	M
潘曙康	M
陆丁妙	F
强向军	M
尹泽军	M
曹永超	M
严瑞凯	M
陈维艳	F
严达	M
黄刚	M
徐昆芳	F
郭振云	F
王浩	M
韩俊盟	M
李文文	F
浑雪颖	F
袁茜	F
陈栋	M
宫东洋	M
杜巧男	F
周卫定	M
祝昌香	F
王力	F
邵亚坤	M
翟素俊	F
许琴	F
何凤保	M
何登保	M
王天会	F
韦颜彪	M
邱波	M
丁东东	M
邵国强	M
刘春平	M
陈小红	F
池豆豆	F
刘志佳	M
王磊	M
刘金金	M
刘潘	M
涂欢欢	M
刘辉	M
杨松	M
胡添程	M
苟琴	F
方利剑	M
张锐	F
胡秋康	M
胡腾义	M
左鹏	M
涂娟娟	F
吴攀峰	M
谢振基	M
谢腾云	M
赖治霖	M
陈佳檑	M
帅婷婷	F
陆燕	F
王用杰	M
蒋小娟	F
孟艳虎	M
赵春	M
潘宇红	F
刘彩霞	F
蔡际聪	M
章单单	F
吕高峰	M
吴申锵	M
颜西宁	M
王增	F
栾键泽	M
杨南杰	M
赵若超	M
刘燕	F
赵洪彬	M
沈晶晶	F
季杰	M
郑艳	F
李洪秀	F
吴艳红	F
罗花	F
吕季云	M
肖友梅	F
张文静	F
池冉	F
蒋杨易	M
刘鑫	M
占志刚	M
张展	M
江琴	F
杨文超	M
杨志兵	M
白雪强	M
张成云	F
罗强	M
饶志波	M
陈宇创	M
陈小丽	F
向莉	F
赵凯凯	M
涂有桂	F
刘艳玲	F
涂娇	F
陈远智	M
田昕	M
房磊	M
王丽	F
田兆宇	M
彭亚男	M
叶梦婷	F
钱志海	M
张雯丽	F
卢冰	F
袁丽苹	F
陈强	M
胡名丰	M
杨凯	M
胡绍安	M
阮柳军	M
高永奇	M
庄智杰	M
徐小泽	M
甘远波	M
唐福细	M
付荣荣	F
齐斌	M
王清祥	M
汤义栋	M
钟梦华	F
余中南	M
王智琴	F
沈时元	M
蔡龙龙	M
姚小华	F
奥瑞超	F
雍定玲	F
李鸣鸿	M
夏金晓	F
刘秋香	F
戴晶晶	F
罗纪伟	M
任军	F
马兴燕	F
戴喜莲	F
梁娴	F
张成才	M
范春霞	F
陈银银	F
李方捷	M
蔡玉兰	F
江徐颜	M
王成龙	M
胡卿	F
张国定	M
闵琦	M
王痛快	M
濮素维	M
曹克龙	M
郭振飞	M
秦雁寒	M
阳高	M
张静静	F
陈冬东	M
安慧萍	F
卓江浩	M
徐文娟	F
姚伟峰	M
王萍	F
范瑞吉	M
韩志国	M
张昌江	M
王辉	M
黄姣姣	F
颜海云	F
魏兴成	M
周磊	M
余洋洋	F
麻晓萍	F
麻尤素福	M
张婷婷	F
郭齐	F
李婵	F
黄锟	M
瓮俊	M
李友芳	F
杨芳	F
彭为强	M
周文免	M
赵琪	M
周陶钰	F
付发祥	M
陶水玲	F
杨露露	M
高业武	M
李金梅	F
卓孝强	M
陈梦瑶	F
孙英	F
武林枝	F
余梦玲	F
朱巧伟	M
杨昊	F
余红琴	F
江心雯	F
常全超	M
谢静	M
唐曹杰	M
吴镇成	M
罗祖琴	F
程会云	F
饶天咏	M
吴青	M
谢英娇	F
蔡宗磊	M
李克晋	M
王志伟	M
李欣	M
李龙	M
闫妍	F
朱听	F
许琪	F
徐贤东	M
黎亚容	F
张国强	M
田中芳	M
王虎	M
只亚男	F
樊聪会	F
张军	M
朱燕峰	M
李小华	F
蔡莉萍	F
黄夏斌	M
肖静	F
陈朝峰	M
张镇东	M
马志超	M
邹慧娇	F
谢季伟	M
王曼	F
刘伟	M
董国龙	M
李培莹	F
陶林翼	M
陈梦云	F
梅锋	M
郭勇华	M
王蓉	F
程健	M
陈孝坤	M
沈耀	M
罗妹金	F
周玉秀	F
吴旬	M
钦诗婷	F
郭娟珍	F
彭冲	M
刘树荣	M
魏战峰	M
程宗国	M
张美珠	F
戴旭霞	F
许治勇	M
刘桂平	M
肖庆华	F
焦美芝	F
陈佳宇	M
肖建华	M
黄德辉	M
李辉	M
王维芹	F
吴光军	M
赵春静	M
吴思琦	F
周峻	M
梅继人	M
马海江	M
林吉栋	M
杨正良	M
常艳瑞	F
杨庆娟	F
詹夏敏	M
代国强	M
王常军	M
石忠霞	F
沈永刚	M
张东兴	M
余银凤	F
袁超	M
廖锡武	M
彭莹莹	F
蒋传桥	M
曹钢华	M
宋琪	M
邢玉全	M
米松	M
陈凌莹	F
孔令盼	M
孙纯东	M
田武	M
陈贵	M
柳逸韬	M
许露娜	F
舒红苗	F
王喜喜	F
叶军福	M
吉布达夫	M
薛亚芳	F
莫宣	M
周贝	M
李晓雷	M
任季凯	M
刘坤	F
晏小梅	F
高斌	M
王焕林	F
刘美	F
姜鑫涛	F
林林	M
潘立洋	M
侯宝嵩	M
杨冬	F
马玉萍	F
施升磊	M
岳智	M
熊立兰	F
罗豹	M
马文俊	M
王磊利	M
王延露	M
江永胜	M
梅龙	M
雷以南	M
闫晓雨	M
马国华	M
马格外米	M
章泽群	F
胡小妹	F
李欣哲	M
马少华	F
张小俊	M
宋洋	M
孙军	M
杨磊	M
李孝军	M
熊绍民	M
李亚乐	M
马辉山	M
周文霞	F
朱小员	F
彭丹	F
熊善景	M
庄守卓	F
范元鑫	M
姚贞沉	M
毛晶	F
李红艳	F
李林峰	M
何资	M
夏敏	F
金逸浩	M
杨林	M
田新婷	F
陈朝芳	F
连兴旺	M
王新军	M
刘维	F
高泽勇	M
琚果	F
麻索么乃	M
罗雨	F
王玉宏	M
周稳政	M
颜吉亮	M
刘广	M
张法制	M
桂厚胜	M
张凤秋	F
李鑫	F
李经琪	M
祝家健	M
赵弟	F
杨梦	F
王领超	M
裴蕾	F
李兰兰	F
谢文娟	F
杨蒴	M
胡文	F
龚园园	F
邵帅	M
张迎增	M
徐乾峰	M
宋佳敏	F
李慧	F
王瑞云	F
郑炜	M
李润	M
徐海生	M
刘倩倩	F
彭俪涵	F
李佳贝	F
崔佰朝	M
林娜	F
王啟明	M
冷文	M
王双佳	F
胡波	M
莫锡联	M
郑云新	F
叶小亮	M
林一妮	F
王乾	F
黄卫德	M
邱现状	M
付德才	M
王少奇	M
居建操	M
钱张灿	M
汤传飞	M
丁伟然	F
饶俊水	M
许朋飞	M
熊娟娟	F
叶敏	M
徐乾照	M
王政	M
田鹏	M
何葆坤	M
张志远	M
吴萃	F
陈敬龙	M
李喜莎	F
马清清	F
庄璐	M
余火立	M
刘珂	F
金相威	F
胡书凤	M
马鹏飞	M
胡思远	M
冯紫阳	M
汪璐璐	F
张海玲	F
喻蒋嫒梓	F
陈冬东	M
高月红	F
肖姗	F
金雨慷	M
江翠萍	F
尼博文	M
谢超	M
董图志	M
常华	M
于波	F
郭强	M
叶伟杰	M
朱坤敬	M
殷伟刚	M
张青	M
张文红	F
项梦晴	F
竺燕波	F
刘恒	M
方正	M
苏锦坤	M
张海霞	F
丁宜晨	F
陈永芳	F
尚江城	M
赵小录	M
武海洋	M
孙青旭	M
彭其兵	M
吕阳	M
李圆圆	F
李邦琛	M
田鹏博	M
毛晓飞	M
段思佳	F
蒋丹	F
李强	M
张强	M
马鑫	M
杨秀铭	M
陈丹娜	F
贺文高	M
邢含薇	F
王卿青	F
张妍	F
黄逸轩	M
贺建峰	M
舒申成	M
杨欣	M
高小情	F
张梦兰	F
方燕娟	F
蔡运龙	M
聂丽萍	F
唐金平	F
姚丽萍	F
徐远恒	M
杨桂松	F
常黄亮	M
李红圆	M
宋相锋	M
李子英	M
曾茂	M
熊传彪	M
齐永堃	M
陈立锋	M
敖贵芳	M
杨光志	M
郭玉杰	F
吴军保	M
毛伟龙	M
武卫东	M
董政波	M
黄金金	M
李婧芬	F
蔡丽丽	F
王浪	M
周景慧	F
刘建学	M
梅德毛	M
蔡先旺	M
孙敏	F
牛桂杰	M
石瑞	M
魏鸿莲	F
罗志	M
鲁德志	M
张建成	M
马赞	M
汪耀	M
吴丹	F
薛国杰	M
谢任强	M
江旺中	M
杨立润	M
黄鹏	M
赵一佳	F
叶鑫	M
邹文军	M
龚成铖	M
刘慧	F
李增辉	M
赵瑞坤	M
李德臣	M
肖旭东	M
刘玉静	F
李光	M
王健	M
黄大炳	M
刘凯月	F
王仟	M
汪可金	M
吴浙川	M
夏沛然	M
程冬杰	M
杨岚	F
聂丹阳	M
张永高	M
邱婷	F
康旭龙	M
孙富金	M
熊腾涛	M
李凯林	F
应江炳	M
汪小霏	F
杜春凤	F
崔凯峰	M
周慧聪	F
邓苁荣	F
黄青	M
史亚允	M
姚慧婷	F
翟有宝	M
刘吻	M
齐莹	F
白雪静	F
柳非凡	M
李润超	M
马平	F
单荣昌	M
葛一飞	M
丁陆益	F
邬应威	M
贺才旺	M
冷金影	F
杨敏才	M
杨雪3	F
张卓	M
马有奴	M
孙华军	M
张浩伟	M
翟光成	M
刘景山	M
郭艳	F
邓聪	M
梅雪黎	M
廖远洋	M
王海胜	M
李永泽	M
王玉育	M
李淑芬	F
张建红	M
周铭蝶	F
杨方	M
李远	M
赵荣花	F
余仁榀	M
喻红亮	F
景荣杰	M
毛文波	M
位保振	M
郑士旭	M
邓柯	M
李丙飞	M
谢先华	M
张云	F
王振凯	M
马利超	F
徐慧轩	F
雷孔福	M
邓子明	M
陈天	M
张梦婷	F
符永杰	M
李慧琴	F
李泉友	M
熊广华	M
碗月丽	F
张廷朝	M
班虎	M
许雅辉	M
余小燕	F
谢丽君	F
唐亮	M
闫东磊	M
宋亚洲	M
闫金文	M
杨胜凯	M
李凯	M
张玉玺	M
石转	M
蒙丽燕	F
曹昌顺	M
邹丽萍	F
赵国宏	M
杜文杰	M
周世豪	M
张国栋	M
雷正宇	M
彭胜财	M
赵满金	M
张园花	F
万勇	M
程香娜	F
朱程程	F
范安然	F
朱庆亮	M
陈春雷	M
徐从飞	M
何恩	M
周进香	F
张广学	M
杨永仙	F
张超颖	F
俞国庆	M
盛志勇	M
徐世杰	M
马书威	M
盛世才	M
程媛媛	F
李曼	F
王永浩	M
冯银彪	M
务圣寅	M
韦社奇	M
王瑾钰	F
桑涛涛	M
张石生	M
陈一栋	M
张彦召	M
任逸飞	M
魏巧巧	F
周武根	M
关俊辉	M
于翠荣	F
蔡鹏	M
贾贵琪	M
蒋欣航	M
徐淑宏	F
杨海伦	F
余文海	M
贺辉凌	F
何海飞	M
杨国龙	M
杨奇良	M
马小飞	M
邓栋梁	M
刘岩	M
王新岚	F
彭文辉	M
马春梅	F
匡兴佳	M
夏云	F
史佳楠	F
李周	M
刘凡军	M
吴旻	M
王丽玲	F
刘晓楠	F
昌成龙	M
刘贵梅	F
邱细国	M
金璐锋	M
孙秋霞	F
刘智慧	F
程川女	F
李宁	F
林钦明	F
楼齐	F
徐依静	F
张泽华	M
何鹏	M
李巧云	F
杨雨州	M
邢立佳	M
吴来东	M
吝瑞生	M
尹自云	M
金荣泰	M
肖雅	F
孙迎浩	M
马艾有布	M
李云鹏	M
张琴	F
蒋智敏	F
岩闷	M
唐芳芳	F
毛文昌	M
龚雪勇	M
刘南南	F
王腾	M
赵琳	F
任萌	M
包瑜婧	F
肖才吉	M
黄聪	M
罗骏	M
袁娟	F
张吉鹏	M
商迪亚	F
袁磊	M
崔继通	M
罗丹阳	F
彭仙女	F
杨运明	M
杨森	M
张黎	F
秦永发	M
桑福云	F
曹琴	F
徐丽平	F
孟妍	F
昌德琴	F
刘继兰	F
孙晓莉	F
陈玉芬	F
周建青	F
吴越	M
徐兴亮	M
袁密	F
章奇勋	M
张丽丽	F
王方成	M
张铭	M
王志兵	M
张雪芬	F
尹五洲	M
张承贵	M
丁满菊	F
王雪梅	F
柳玉红	F
夏鹏	M
葛宋芹	F
杨秋菊	F
江国鑫	M
武琛	M
李海南	M
牛红艳	F
郭真真	F
徐望兴	M
陈梓荣	M
周露燕	F
张磊	M
陈翠平	F
邓林冬	M
罗美琴	F
赵浩磊	M
邓付根	M
刘运良	M
康小强	M
贺元军	M
任超	M
徐康	M
李磊	M
刘明珍	F
熊卿地	M
李慧琳	F
朱懂懂	M
党昌贵	M
余柏善	M
葛雄	M
赵伟	M
王小兰	F
汪倩倩	F
马嘎	M
王晴勇	M
杨心愿	M
查湖滨	M
刘甫欢	M
欧金	M
程开阳	M
沈艺	M
肖本华	M
马仿	F
杨金吕	M
何旭斌	M
包强	M
胡秋华	F
金俭根	M
石华庆	M
金锡财	M
朱斌	M
贾爱叶	F
向宇翔	M
史太龙	M
虎振	M
张明杰	M
王维花	F
龙光现	M
陈宇	M
严慧琳	F
李祖锵	M
张玉玺	M
康海香	F
吴金云	M
陈佳萍	F
汤智剑	M
田佳佳	F
卢祖引	M
叶正飞	M
李雷国	M
徐青换	F
陈恒才	M
张飞	M
董永胜	M
苏会敏	F
毕胜平	F
汪龙	M
单健威	M
严乐	M
张敬尧	M
袁波荣	F
张天华	M
张凯	M
方佳兵	M
高亮	M
吕静	F
曾俊雄	M
陈存昌	F
刘召恩	M
曾平杏	M
马小兵	M
杨承昊	M
蒋贤君	F
邹坚	M
李芳	F
王金辉	M
王圣锋	M
冀灵灵	F
龙红秀	F
马兰	F
刘刚	M
张润生	M
谢科	M
谭建中	M
翟犇	M
曾文伟	M
陈雨杰	M
李春艳	F
吴荣义	M
邬幸杰	M
闫磊	M
卢鹏	M
邢龙骏	M
王锬	F
程排风	F
胡洪昊	M
杨胜军	M
邱鹏颖	M
董彩燕	F
杨金梅	F
熊伟	M
陈文英	F
张丽	F
王礼国	M
王玉起	M
胡丽萍	F
郭腾飞	M
周亚	M
王前	M
郑青春	F
胡凯	M
邓国祥	M
卢芹	F
曾晓娜	F
夏金辉	M
黄元福	M
李福全	M
郭帅	M
张仕达	M
郭青青	F
刘序文	M
刘强	M
任璐	F
陈华	F
郜云飞	M
伍秋平	F
吴才鹏	M
沈亚丽	F
方金波	M
黄树林	M
潘岳彪	M
周义欣	M
崔曼琳	F
熊娟	F
周易磊	M
赵海兵	M
张云芳	F
褚慧丽	F
耿世伟	M
李瑶	M
郑扬	M
刘桂花	F
程文婷	F
熊绍志	M
张静华	F
委兴辉	M
方翠	F
郑长明	M
徐佶	M
汪义启	M
王赫安	M
薛路	M
肖梅	F
夏敏	F
顾丽华	F
向红丹	F
黄海	M
吴胜梅	F
吴斌	M
岳容兵	M
叶春欣	F
韩彬勇	M
刘飞德	M
陆传统	M
马学才	M
杨柳	M
苏志彬	M
秦冰	M
田正飞	M
耿添添	F
李松	M
杜莎莎	F
程保岭	M
陆方炜	M
宗小华	M
韦光梅	F
范自彬	M
周明飞	M
朱太星	M
王剑	M
张灿	F
李玉珍	F
刘柏云	M
鲍洋	M
邹顺	M
罗兵	M
张纯鹏	M
蓝天明	M
汪晓梅	F
刘洋	F
梅文超	M
王铭磊	M
刘原源	M
刘锐	M
钟媛媛	F
周雨利	M
马海伦	M
毛晶晶	M
张建建	M
杨春艳	F
汪可芹	M
曹国邦	M
马学	M
陈秀丽	F
房红英	F
王浩宇	M
张辉	M
李想	M
齐浩然	M
罗彪	M
端俊超	M
陈根	M
陈美珍	F
吴兆萍	F
水口浩一	M
仁珍珍	F
姚亚明	M
叶志民	M
杨水平	F
陈聪	M
余有付	M
赖草元	M
李发银	M
王磊	M
王燕燕	F
覃敏	F
周磊	M
张金霞	F
徐祥	M
苏军宇	M
罗安兴	M
徐新凯	M
孙进	M
邓祥杰	M
李明正	M
程忠山	M
伏永春	M
唐啸天	M
孙博涵	M
黄帅帅	M
朱焱林	M
谢明亮	M
刘帅印	M
钟平霞	F
程忠华	M
张毅	M
卢青松	M
甘露露	M
郭明喜	M
李旦	F
曹守云	F
王天明	M
宋鑫桐	F
易敬	M
陈亚龙	M
涂国洋	M
孙启荣	M
郑伟东	M
李小冬	M
周冬梅	F
付金营	M
高孟豪	M
林玉峰	M
赵鑫	M
赵弄弄	M
康海萍	F
肖鑫武	M
崔日宝	M
王奇伟	M
周毅康	M
王华	F
陈乾坤	M
卢兴邦	M
宁增杰	M
吴承祥	M
王娟	F
庄卫强	M
徐港平	M
郭走壁	M
李丹丹	F
王微	F
王自彦	M
占彬	M
杜佳	F
丁峰刚	M
舒娟	F
李建国	M
庞永红	M
彭程	M
宋莉	F
俞佳慧	F
张诗祥	M
陈爽	F
彭继伟	M
郭迎飞	M
陈秀云	F
成旭	M
赵江	M
肖丰	M
房旭东	M
吉小琴	F
杨艳博	M
陈慧萍	F
杨超	M
龙江	M
周宁佼	F
安鸿斌	M
陈代军	F
申凌	F
侯锐	M
陈浩东	M
申关保	M
朱文冬	M
梁凯强	M
耿长英	F
陈可可	F
谢淞臣	M
鲁从军	M
赵富德	M
李程林	F
文付英	F
黄世伟	M
黄俊飞	M
吴萌	F
雷纪春	M
王远贵	M
宋玉仙	F
邓兴虹	M
杨尚沄	M
朱杰	M
厉彪	M
殷汉铭	M
唐晓	F
孙元林	M
孔诗婕	F
郭京华	F
郭斌	M
泮夏南	F
刘荣荣	M
李伟	M
张祥	M
荣元峰	F
陈渊斌	M
李斯嘉	M
刘亚玲	F
张宁	F
张典军	F
赵洋	M
梁光龙	M
李相全	M
刘文琦	M
付明扬	M
张超	M
张发	M
周双萍	F
王鑫	M
王波	M
陈永	M
王钒	M
田玉珍	M
刘金金	M
陈冰秀	F
杨平俊	M
王金朋	M
周俊祥	M
吴旭	M
邱望岚	F
邓欢	F
罗仕雪	M
史月朗	F
刘星	M
竺乖叶	F
孙洁	F
陈显显	F
况克勇	M
熊润妹	F
袁平放	M
涂玉平	M
陈小芳	F
赵英英	F
董秀艳	F
倪娴	F
陈恩光	M
杨菊芬	F
芦根土	M
包苏菊	F
蒋水菊	F
陈力	M
赵元欣	M
虞世国	M
李忠德	M
胡仁花	F
吴应武	M
马成虎	M
黄敏君	F
龚雪妃	F
任珊云	F
林浩伟	M
王姣丹	F
王莹	F
张运蝶	F
杨志洁	M
王振伟	M
赵艺	F
陈仕祥	M
盖宁	M
蒋瑾	F
张璐琦	F
张好文	M
吴芝琳	F
费载敏	F
余志海	M
彭科	M
林航	M
项媛	F
舒晨	F
许美娇	F
汪新富	M
李璟华	M
郭建丹	F
刘金环	F
候宗静	M
光泰高	M
闫运超	M
龙刚	M
董根胜	M
姚点锋	M
郭超峰	M
王廷廷	M
罗福江	M
高标	M
杨绪文	M
蒲培清	M
张少东	M
阮绍芳	M
李志高	M
黄良基	M
王刚	M
徐晓雲	F
孙胜勇	M
胡远航	M
卢文天	M
陈慧	F
沙涛	M
韩永锋	M
尹正林	M
傅振锋	M
马强	M
陶茂名	M
洪志凡	M
杨涛	M
周鑫	M
王兴武	M
张小粉	F
张少寅	M
杨钊	F
蒙昌梅	F
王雪	F
周茜玉	F
李嘉	M
党凡	M
王进宝	M
王华	M
梁素娟	F
韩奴来	M
王小鹏	M
孟令海	M
周晨晨	F
徐恩明	M
逯逍	F
张超	F
黄业涛	M
杨东	M
刘兴	M
郝艳	F
徐垒	M
刘美文	M
金艳军	M
余媛媛	F
邹美华	F
宁耀星	M
解开朝	M
王鑫领	M
韦善平	M
魏洁	F
袁柯柄	M
王秋淑	F
廖丽娟	F
屈玉柱	M
周奎	M
高杰	M
吕文萍	F
张蒙	F
余家林	M
应该	F
张露	F
张娟	F
赵国芳	M
刘健	M
胡宏达	M
张义城	M
李保柱	M
许庆柱	M
祖华明	M
凡刚	M
青熙如	M
朱燕婷	F
马舒琪	F
陈绍宁	F
杨俊杰	M
柯喻	F
杨国庆	F
汪幼玲	F
冉超	M
胡敏	M
胡今宝	M
郑帅	M
张明杰	M
翟瑞麟	M
杨玉泷	M
陈威威	M
马铭	M
杨旭	M
宋万会	M
何飞	M
蒋幼利	F
施密	F
吴晓晓	F
徐芝君	F
黄国平	M
金贤龙	M
吴学文	F
朱胜利	M
陈琴琴	F
徐辉	M
刘旬波	M
黄敏	M
廖胜	M
张平	M
张利辉	M
杨吉梅	F
宋建文	M
高坚	M
任峰东	M
李新杰	F
杨田	F
杨维	F
瞿茂林	M
尹萍月	F
吴增军	M
陈焱英	F
施天龙	M
杨梅	F
秦林蔚	F
毛进	M
王肖东	M
尤云龙	M
王海聪	M
张智良	M
陈远胜	M
高方正	M
朱杏	F
杜旭卿	M
王静	F
李鸿贵	M
陈加健	M
沈鲁泽	M
朱圣安	M
朱礼清	F
黄磊	M
唐艳华	F
潘先年	M
谭全明	M
杜云	F
余华能	M
杨依	F
段遥	F
袁娟	F
陈瑶	F
吴姣辉	F
张月昌	M
刘碧君	F
倪沙	M
刘俊奇	M
李素生	M
王玉琴	F
陈涛	M
查立东	M
习超	M
高文豪	M
王双	F
万里军	M
母堯文	M
刘正	M
姜东梅	F
黎冲	M
陈诗雨	F
张云仲	M
管秀燕	F
毛伟伟	M
郭卫超	M
陆艳	F
左雪兵	M
吴喜兰	F
郑胜悦	F
陈微	F
刘苏宁	F
李丹阳	F
谢鑫炜	M
周婷婷	F
宋丽丽	F
程昆鹏	M
周鹏	M
索佳佳	F
张晓梅	F
孙晓峰	M
洪伟林	F
钱菊萍	F
沈荣花	F
蒋雨飘	M
沈顺	M
黄燕	F
邵佳晴	F
向香秀	F
夏艳梅	F
孙璐	F
周雪	M
李峥嵘	F
张磊	M
丁丽华	F
马燕	F
裴菊红	F
蒋平平	F
吉兆洋	F
叶正	F
于丽敏	F
滨田尚宏	M
邹心妮	F
张志强	M
黄腊香	F
康春莲	F
娄晓艳	F
王贤本	M
徐礼果	F
杜国洪	M
马玉萍	F
杨亚宁	F
刘明姝	F
封国兴	M
项素梅	F
董芳	F
李婵	F
韩宗孟	M
吴华昆	M
易昆	M
周和定	M
李明阳	M
徐勇	M
陈海波	M
雷榴	F
刘丹	M
徐小枫	F
李云龙	M
吴奕晓	F
胡永跃	M
陈小杰	F
杨广	M
周雨露	F
黄圣	M
刘悦琳	F
方健	M
祖祥	M
王坤	F
肖桂双	F
张青	F
谈荣林	M
王庆松	M
万连德	M
袁惠平	F
闻锡君	M
王幼尔	F
王李勇	M
郭芳英	F
沈友福	M
唐玉娥	F
李在兰	F
蔡彩芳	F
吴玉意	F
徐青秀	F
余淑媛	M
谢银林	F
张燕萍	F
徐莉贞	F
周时奎	M
程伦祥	M
陈科伟	M
严建国	M
单聪儿	F
陈若莹	F
陈明立	M
马传仙	M
芦根宝	M
任国飞	F
刘超	M
叶启英	F
庄启永	M
樊继臻	M
王引	F
潘超	F
陈丹丹	F
曹碧文	F
施缘份	F
肖勇	F
王晓滢	F
王小曼	F
郑成龙	M
杨秀	F
李春林	F
孙婉婷	F
范倩文	F
危耀祖	M
丁钊帅	M
邓文丽	F
王宇	F
陈飘	F
高金华	M
赵丽丽	F
陈彦云	F
王勇平	M
樊欣	M
刘纳	F
姜灵燕	F
姚菁	F
刘絮蓉	F
赵帅	M
胡晶	F
周明磊	M
袁瑞芳	F
王有强	M
陈科	M
吴莉珍	F
金鸿兵	M
黄富木	M
卢兰纪	F
洪雯婕	F
向阳	F
刘丽	F
赵保红	M
周旭正	M
谢剑平	M
贾福龙	M
陈云	M
方金玲	M
吴琼	F
王亚娣	F
周祥	M
李言言	M
徐军明	M
卢江燕	F
马哈五则	F
王庆贤	M
李晓海	M
张大勇	M
刘艳辉	F
李高	M
陶建宇	M
葛成龙	M
彭丰	M
袁爽	F
杨春花	F
张菊琴	F
王潮	M
姬存梅	F
陈胜华	M
涂省兵	M
谢钱妹	F
张杨	M
詹金球	M
王密	M
李志	M
宋国旗	M
熊孙俊	M
张学龙	M
崔东岳	M
朱楠	F
肖齐	M
李世研	M
张春	M
徐嘉敏	M
侯吟	M
郑红平	M
曹明兰	F
熊小平	M
马志文	M
沈幼苗	F
谢水香	F
李圣辉	M
李圣华	M
刘强	M
涂克妹	F
华芳	F
朱天宝	M
杨小娜	F
张吉良	M
章叶	M
杨华军	M
雷金发	M
王义	M
邓梅	F
王海洋	M
唐朝波	M
吴谦宝	M
程邵	M
徐欣	F
毛伟栋	M
马丽娜	F
向福凯	M
王新文	M
吴洁	F
李士华	M
卓志坤	M
耿晓增	M
刘兆君	F
杨乐	M
王清连	F
包建权	M
白晏华	M
尉健强	M
雷文杰	F
徐玉玲	F
操和龙	M
申屠英琴	F
吴强	M
陈欣	F
许剑晓	F
朱宝霖	F
蒋佳奖	F
张美德	M
洪芳国	M
夏平平	F
薛晓兵	M
崔北明	M
严冠军	M
钱照静	F
徐乐炳	M
吴朵朵	F
李浩然	M
李杰杰	F
祝丽云	F
李亚萍	F
管志军	M
邱家鹏	M
任向攀	M
王平	M
洪伟波	M
张万勤	F
李天养	M
王岩	M
刘洋	M
王洪运	M
黄建勋	M
王园	M
孙晓龙	M
王耀	M
虞静	F
李江辉	M
肖彩红	F
邱华香	F
饶秀军	M
娄卫波	M
张涛	M
丁玉丽	F
李长江	M
王艳青	F
白娟	F
石丹辉	F
杨鸿丽	F
杜明洁	F
郑红梅	F
吴旭波	M
贾现委	M
胡品	M
王盛	F
董文静	F
韦春云	F
化霜	F
陈菊花	F
刘继文	M
李明亮	M
梅本祥	M
罗松	M
李嘉星	M
潘启青	F
赖宝珏	M
武晓雅	F
王彪	M
马乐	F
张小娜	F
杨丽娜	F
董帆	M
卢心廷	M
李怡	F
周凤梁	M
王利波	F
毛振威	M
许裕龙	M
叶高峰	M
王锰蕊	F
杨敏	F
徐占彬	M
朱斐飞	F
袁学燕	F
秦海丽	F
刘雨	M
马侣	M
高宪英	F
傅子豪	M
董世伟	M
尚志刚	M
汪玉霞	F
牟永见	M
吕成	M
毛国都	M
杜亭	M
崔波杰	M
董明英	F
龙如兵	M
周晖红	F
刘宏超	M
戴书强	M
靳松	M
马兴梅	F
姜东	M
李培瑞	M
李永涛	M
李芸	F
王钊	M
刘涛	M
梅珊珊	F
黄燕东	F
张建新	F
杨之梅	F
何圣泽	M
齐浩然	M
杨志	M
贾海静	F
刘臣宇	M
伊国会	M
靳宇娟	F
李蕊	F
马文瑞	M
郑思思	F
郑秀红	M
张鑫	M
李小丽	F
廖芫	M
郭子旭	M
谢凤月	F
毛华军	M
左震	M
彭志辉	M
彭志波	F
王树宵	M
谢国庆	M
邵荣	M
杨亮	M
谭超	M
阮君萍	F
王纹纹	F
赵航航	M
王秋月	F
吴霞	F
杨义	M
甘宇婷	F
随涛涛	M
赵珊珊	F
杨立宏	M
聂潘	M
吴孝飞	M
江风彩	F
杨红彪	M
丁胜	M
沃思奇	M
沈俊	M
杨啟超	M
席秀丽	F
李静	F
陈胡军	M
叶恒益	M
郭丽品	F
熊福青	M
吕生森	M
程建	M
章鹏	M
夏小槐	M
凌苏波	M
程冬连	F
韩水坚	M
时桃花	F
石学海	M
刘志国	M
熊振宇	M
周成义	M
崔佳莹	F
徐辉	M
张真	M
程本泽	M
钟俊武	M
王悦敏	F
张佳钰	F
孙可可	M
娄金莎	F
张奕超	F
时瑞坤	M
胡多志	M
张辉颖	M
杨琴	F
张建忠	M
张灵杰	M
丁彦方	F
徐李鹏	M
时瑞	M
王清梅	F
胡丛丛	F
张雨秋	F
刘创	M
杨凯迪	M
张连冲	F
白圆圆	F
汪知飞	M
黄丹丹	F
张乾坤	M
王小鹏	M
滕召水	M
黄晓飞	M
程殷益	M
杨荣龙	M
李彬	M
欧阳健颜	F
周发文	M
段晚秋	F
王小迪	F
欧阳万普	M
黎琪	M
杨红平	F
李福玉	F
马宇辉	M
胡超	F
彭洪	M
刘连有	M
郗锦程	M
关凯	M
谷冰	M
吴娜娜	F
黄英	F
任洋洋	M
杨睿	M
杨洁	F
熊伟伟	M
郭磊	M
郭文博	M
张航	M
聂洋洋	M
余文辉	M
王影	F
马悦	F
曹玉林	M
吴波	M
杨秀成	M
杨兰平	F
文晓娟	F
叶青	M
田涛	M
谢图迈	F
周佳楠	M
彭世飞	M
靳智慧	M
陈鸿光	M
陈露萍	F
张卫芳	F
申郭艳	F
黄建伟	M
张春琦	M
何川	M
任军伟	M
张丽君	M
刘新香	F
程杨	M
俞晶	M
朱明菊	F
唐和娟	F
罗伟	M
武永德	M
郑慷	M
吴发枝	M
田素素	F
万琴	F
周虎子	M
陈述	M
沈成波	M
梅文兵	M
祝长安	M
任加祥	M
王瑜	F
刘书洪	M
黄国新	M
崔利芳	F
高福	M
齐泽军	M
王晓军	M
汪其桂	M
司伍刚	M
侯跃文	M
韩佳	F
张福音	F
石显鹏	M
蒋世超	M
宋世举	M
胥维	M
周明光	M
孙亚锋	M
周亚星	M
吕永波	M
谢松	M
陈路婷	F
李超飞	M
籍家鑫	M
陈佳辉	M
李大鹏	M
汲海彪	M
彭兴浩	M
刘赛祥	M
王秀飞	M
周静	F
黄秋琴	F
王富贵	M
周勇胜	M
陈慧杰	F
濮林鑫	M
胡苏平	F
林嘉龙	M
许亮娟	F
钱萍	F
罗冬	F
龚晨光	M
贾会东	M
吴晓华	F
毛伟峰	M
周祥稳	F
甘国平	M
张彬	M
唐帮鑫	M
刘瑶	F
易娟	F
陈兵	M
郭严	F
康亚军	M
邓飞堂	M
熊玉玲	F
马辉	M
张怪平	F
周敏	F
周明卉	F
翟海雪	F
胡斌	M
张小花	F
伍化军	M
王凯乐	M
殷强强	M
古宏鑫	F
马生民	M
田琪	F
黄红岩	F
李娜	F
邓其焯	M
曹军荣	F
徐止高	M
杨敬	F
王志雄	M
涂昌龙	M
肖家云	M
朱宝明	M
李鹏辉	M
关博	M
范世沪	M
王晓明	M
熊益武	M
王锐	M
张学军	M
周晖	F
刘绍春	M
桂章斌	M
张莉	F
张雷	M
向文丽	F
张书	M
周朝霞	F
陈红	F
王钰	F
夏园凤	F
张金要	M
杨洁	F
张丽莎	F
张洪丽	F
何宇航	M
张镇委	M
曹安缘	M
杨泽明	M
申运明	M
林建清	M
刘亚宁	F
张爱霞	F
王倩	F
张瑞民	M
朱文超	M
王巨堃	M
万紫红	F
熊丽琴	F
张红卫	F
张春红	F
梁仕波	M
颜淼鑫	M
彭敏	F
朱龙	M
童莎莎	F
吴海燕	F
黄金荣	F
应宇狄	M
邓秋玲	F
吴耀明	M
王志强	M
宁静	F
何瑞盈	F
罗志成	M
陈晨	M
黄珊	F
李成林	M
陈倩倩	F
孟佩佩	F
邓振	M
魏俊	M
张文龙	M
王金艳	F
倪玺	M
贾昌振	M
李晓燕	F
毛宗珍	F
王战步	M
王琪	F
周密	F
陶金鹏	M
李雅楠	F
肖媛	F
徐明慧	M
叶平娟	F
徐辉	M
吕忠洋	M
王洁妍	F
杨永松	M
杜俊立	M
郭威望	M
罗廖红	F
常登金	M
黄金英	F
闫涛	M
石茂琴	F
王韦理	M
孙奕虹	F
刘海生	M
秦立振	M
陈路	M
杜伟	M
鲁子明	M
麻儒冲	M
张霞	F
胡朝健	M
田冰洁	F
田立姮	F
张新玉	F
徐超	M
朱卓青	F
张忠银	F
陈仙勤	F
朱模宝	M
郑红玲	F
周科举	M
何贞美	F
朱锋	M
郑云	M
周彦	M
杨花香	F
钱柏荣	M
章贵彬	M
曹明建	M
陈冯	M
熊慈毅	M
黄分果	F
王茹萍	F
谢静	F
买买提阿曼尼沙	F
王爱辉	F
叶学伟	M
郑俊峰	M
吴金莲	F
彭仁	M
彭瑞华	F
吴立胜	M
孙标志	M
王庆	M
郑琴	F
潘金莎	F
韩勇刚	M
汤邹莲	F
崔东晨	M
庞建平	F
揭迪	M
王杰杰	M
蒲文东	M
周小平	M
王南南	F
单云均	M
吴锦源	M
袁美娜	F
郑海洋	M
张云意	M
雷亚雨	M
谢俊岭	M
陈美秀	F
余刚	M
夏嘉亮	M
范熊星	F
陈一鸣	M
金伏连	F
樊亚宁	M
杨俊明	M
杨占勇	M
李萍	F
沈冬毅	F
阙杨丽	F
王艳玲	F
魏茶香	F
赵娜	F
徐苏妹	F
郑正平	F
洪佰益	M
邓万佳	M
崔杨挺	M
郭耀伟	M
唐金潮	M
商黎焜	M
吕加成	M
倪周迪	M
冯静	F
杨秀香	F
吴其求	M
何锡坤	M
缪林锵	M
罗维	M
万凯利	F
刘宝利	M
毛鑫辉	M
陈丽波	M
汪乔	M
黄芳	F
金月娟	F
陈龙	M
刘经国	M
王昌盼	M
秦联想	M
张琼芬	F
徐昌	M
徐俊	M
任春艳	F
郭玮	M
王其波	M
张高朋	M
韩雷	M
汲万利	M
张昊	M
郭靖	M
张红玉	F
秦江平	M
章高祥	M
张玲	F
谢文杰	M
庞琼琪	F
余婧	F
李盼龙	M
沈世恒	M
姜会泊	F
李敏	F
杨一雄	M
沈芳瑜	F
侯文涛	M
韩金龙	M
邹星灿	M
姜莉	F
罗敏	M
何俊祥	M
万国华	M
赵嵩	M
张燕妮	F
陈潘	M
王文化	M
陈袖彬	M
陈红	M
李满香	F
杨静	F
顾陆洋	M
刘大庆	M
汪大福	M
龚素芬	F
项宗祥	M
袁思思	F
廖春	F
龚晓丽	F
王亮	M
张满红	F
罗小凤	F
王平	F
王凌	M
韩永涛	M
纪金红	F
苗立安	M
李志	M
向军花	F
朱小琴	F
覃秀云	F
黄文娟	F
王芹	F
郝晓婷	F
徐刚	M
郭瑞芳	F
梁宇森	M
李永海	M
宋桂刚	M
王勇	M
吴彪	M
吴志勇	M
应培军	M
王敏	F
石红波	F
陈明辉	M
资欢	M
周艳	F
陈欢	F
蔡露	F
夏贤勇	M
程语芝	F
谢付林	M
梅将俞	M
赵军德	M
徐兰英	F
屈秀可	M
刘爱红	F
胡建东	M
方瑜	F
朱琳	F
鲍海波	M
杜坚舜	M
黄逸慧	F
马海英	F
朱曌华	F
许晶	F
宁晟	M
程磊	M
王星	M
李维玉	M
郭健	M
苏金炬	M
陈哲	M
李新城	M
朱晓飞	M
朱梦瑶	F
戴普金	M
陈艳	F
曹承永	M
刘涛	M
汝建斌	M
陶怡	F
钱水平	M
李福建	M
常幸堂	M
程红兰	F
余昌盛	M
王火勇	M
李浩宇	M
兰华朱	F
刘慧	F
曾庆兰	F
屠群	F
王建军	M
陈堂辉	M
贾国庆	M
赵霞	F
李兰	F
唐航舰	M
尤奇军	M
何才	M
曾志莺	F
汪园	F
焦宇	F
张洁	M
李涛涛	M
李皓祥	M
罗子飞	M
张源	M
沈文龙	M
常慧	F
刘文中	M
严敏	M
侯志涛	M
崔荣荣	F
杨晨	M
邱婷	F
母治军	M
祝桢	F
肖春洪	M
计其恩	M
张丕草	M
赖香梅	F
王丽丽	F
赵秋燕	F
徐刘辉	M
孙红虎	M
侯泽鹏	M
王朝宾	M
陈贤芬	F
宋丹华	M
李高全	F
韩沙	F
严月芬	F
周传路	M
张芳香	F
毛婷婷	F
黄锟	M
林陈	M
蔡静国	M
胡志刚	M
周丹娜	F
王军运	M
陈孝波	M
孙琳琳	F
赵艺媛	F
周秀梅	F
张柏林	M
丁文浩	M
马训香	F
周伟光	M
吴罡杰	M
杨仲夫	M
卢苗华	M
黄伟岳	M
宋亚波	F
李根宝	M
叶能伟	M
傅建佩	F
魏文凯	M
孙艳飞	M
张文玉	F
展林	F
范天骄	M
常少成	M
鲁志强	M
常清林	M
李玉奇	F
姚点庚	M
李红涛	M
任冬芬	F
邵大帅	M
冯科科	M
徐鹏	M
李霞	F
茅伯良	M
王占辉	F
丁仁友	M
孙海燕	F
罗惠珍	F
王超	M
党春辉	M
周亚芳	F
钱亚伟	M
张友燕	F
吕莉	F
江俊	M
李豪森	M
孟萦	F
许前丰	M
武静霞	F
陈亚萍	F
徐燕波	F
吴孟永	M
宁莉	F
李列荣	M
罗思怡	F
周瑱	F
邹毛秀	F
龚行剑	M
颜美	F
李玉琴	F
苏辉靖	M
林海	M
徐小虎	M
韩璐瑶	F
刘光奎	M
孙兆圣	M
马克军	M
林勇	M
黄乐华	F
刘芳丽	F
宁阿童	F
王菊娣	F
吴富华	M
董放胜	M
顾擎宇	M
江娜	F
崔明辉	M
刘伟	M
戴素芬	F
李换玲	F
李子容	F
陆奉贤	M
刘鹉	M
万平	M
王洪银	F
舒云华	F
谢丽强	M
朱丽芳	F
黄均民	M
傅佳雷	M
王阿珍	F
徐海燕	F
郑斌	M
袁亮	M
冯志好	M
陈波儿	F
甘旭阳	M
高育	M
万志强	M
高军立	F
宋晓芳	F
游正铭	F
向实芳	F
范鳐建	M
李珂晗	F
左婉莹	F
吴言清	M
于建波	M
侯亮	M
邹浩	F
冯周虎	M
谢猛	M
秦本勃	M
李彩虹	F
郑添双	M
王花	F
王树杰	F
张洪志	M
王俊伟	M
龚成成	F
勒志扬	M
余龙	M
薛全星	M
邓志鹏	M
张德亭	M
程丹丹	F
顾凯媛	F
薛兵兵	M
楼妍琪	F
朱旭光	M
樊旭	M
王松	M
李寿民	M
田冲	M
高祥	M
冯丽	F
雷国海	M
王星太	M
卢贵	M
熊正凤	F
戴起亮	M
崔同伍	M
李金菊	F
王皓崴	M
张逢逢	M
张世杰	M
程雨婷	F
余怀富	M
龚广球	M
黄龙孙	M
张云婷	F
周斌杰	M
赵坚	M
马克龙	M
张香	F
夏登平	M
郭建林	M
陈爱忠	M
赵源	M
周露露	F
蒙小敏	F
刘惠	M
黄春来	M
胡仕畅	M
王义祥	M
吴海林	M
杨明明	M
王志威	M
彭章修	M
石慧	F
蒋星女	F
谭旭明	M
乔腾	F
杨璐奇	F
许松涛	M
刘海	M
裴玉平	M
刘杨	M
王雅丽	F
唐芷沙	F
吴斌杰	M
成昌荣	M
任玲	F
冯梅	F
徐云涛	M
翟春华	M
黄留亮	M
杨检群	M
赵云	M
胡航	M
程露露	F
刘兵	M
黄坤鹏	M
赵卫	F
扶胜根	M
吴春露	F
姚远	M
杨婷	F
赵路兵	M
崔辉	M
王朋	M
方清清	F
于穆泽	M
贺剑鸿	M
熊运利	M
孙德昌	M
余孝君	M
李静	F
王修丽	F
李婷	F
李兴旺	M
林丽金	F
蔡晓艺	F
周雪婷	F
刘方园	F
耿有杰	M
王万江	M
朱姗	F
陈宏颖	F
周奇辉	M
张宇庆	F
李树龙	M
吴双珠	F
万敏敏	F
陈亚	F
黄娟	F
夏伟胜	M
张贺超	M
许安航	M
李钰	F
李君跃	M
何生成	M
巫玉琴	F
黎静霞	F
陈超燕	F
马静辉	M
单朝阳	M
裘晨琦	M
周丹	F
王秀云	F
李士杰	M
陈欣	F
关孟施	F
付亚丽	F
吴文静	F
邵欢婷	F
文亚飞	F
陈紫怡	F
柳志康	M
杨勇	M
王晓建	M
刘守鹏	M
穆盈盈	F
钟镇	M
罗嘉奇	M
候瑜	F
翟君燊	M
吴新央	F
陆许晶	F
刘艳梅	F
夏小胖	F
毛永峰	M
田宏华	M
孙昌斌	M
钱建利	F
张松旺	M
邹华春	F
彭建	M
江志金	M
张青青	F
李原亮	M
沈健	M
李晶茹	F
周升开	M
郝明华	M
赵英	F
林科伦	M
杨锋	M
苏妮娃	F
贾银华	F
金志坚	M
胡明	M
黄锐	M
蒲彧	M
刘云鹏	M
王奎亮	M
高龙飞	M
刘君	M
谌智明	M
陶彩霞	F
颜豪	M
刘其	M
王忠华	M
曹桂群	F
袁晓丹	F
廖先宇	M
吴涛	M
付延康	M
侯阿会	F
李新转	F
师永顺	M
李洋	M
万水花	F
李洪宾	M
阳媛媛	F
王金环	F
赵华	M
闵诗琪	F
陈志敏	M
胡艳霞	F
郑位棠	M
孙希元	M
欧阳克昆	M
胡圆圆	F
周鹏飞	M
江挺	M
龙方	F
孙宇	M
吴婷2	F
赵家琳	F
谭泳佳	M
邹小强	M
周文振	M
徐嘉乐	M
周善义	M
罗俊	M
朱萍萍	F
张玲玲	F
郭少舟	F
俞琪	F
唐文强	M
黄魁	M
王亚珍	F
赵云来	M
马玉波	M
张小艳	F
胡芳秀	F
陈锋雷	M
殷胜男	F
滕建平	M
尤帅帅	M
史燕	F
田廷鹏	M
蔡佳映	F
熊秀梅	F
万怡婕	F
彭海东	M
李佳鑫	M
迟辽原	M
宋从荣	M
许伟冬	M
田昊承	M
单观丹	F
孙阿玲	F
陈梦芸	F
钟伟	M
江军	M
彭雪	F
刘咸阳	M
王亚琪	F
廖秋生	M
顾宜昌	M
段文亮	M
宋佳	F
张加满	M
张玉涛	M
张钰婷	F
张敏	F
李志强	M
李桂花	F
郭玉萍	F
刘蒙欢	M
徐柏文	M
芮圣飞	M
任海萍	F
顾箐箐	F
王毕云	F
徐东杰	M
钟晓琦	F
陈辉煌	M
张少波	M
周行	F
李开放	M
马鹏伟	M
高福	M
卢冬	M
朱肖玲	F
周娟	F
谢正全	M
陈中华	M
张斌	M
祝安定	M
高杰	M
徐智	M
黄大刚	M
李振兴	M
范丽君	F
陈小锋	M
钟怡	F
汤勇	M
高金强	M
汪鲁嘉	M
李厚茂	M
吴涛	M
陈聪丽	F
方智勇	M
薛颖	F
胡绍梅	F
陈潜	M
于婷婷	F
王飞	M
陶启元	M
lionel	M
胡卫平	M
陈红兴	M
柯恩	M
王旭东	M
黎春红	F
吴剑锋	M
宋吕奎	M
刘斯进	M
彭发明	M
刘江	M
王亮	M
郭嵩	M
赵永真	F
孙俊成	M
李辉	M
张传禄	M
项圆圆	F
解晓晓	F
余立航	M
李传超	M
王伟超	M
孙恩翠	F
黄慧	F
冯立新	F
刘世磊	M
付燕	F
楼康	M
滕雨	F
孟宇梦	M
方娜	F
唐爽	M
马慧娟	F
章成	M
刘西根	M
孙嘉伟	M
周宏	M
徐婕	F
苏如权	M
张叶	F
徐勇	M
周忠炳	M
喻师龙	M
黄涛	M
张文文	F
汪丽和	F
胡少波	M
林凤	F
吴秋生	M
李云虎	M
王凤	F
顾美玲	F
陈玉刚	M
葛春燕	F
邱昌晓	F
王晓晖	M
赵永威	M
何再武	M
陶秋红	F
熊丹华	M
张义均	M
董喜明	M
冯立超	M
陈伟	M
朱青阳	M
朱曼倩	F
余辉	M
刘招红	F
刘月	F
刘新根	M
孙冬青	F
张超	M
喻鑫燚	M
张野	M
王超	M
张爽	F
魏德喜	M
罗桃桃	F
伍琴	F
王承景	M
罗俣嵚	F
万芬	F
余雪芳	F
吴楠	F
赵明娟	F
吴嘉承	M
卢周英	F
黄千文	M
王竹	M
李小丽	F
吴宇澜	F
俞婷婷	F
孙小艳	F
张旭	M
王莓婷	F
迟尚胜	M
张英娥	F
汤超	M
徐方刚	M
周情生	M
钟秋桂	F
吴兵英	F
熊国华	M
张明军	M
巨鹏	M
边永康	M
贾鸿本	M
施英娜	F
张翠	F
梁丽	F
曾丽丽	F
梁广	M
田洪伟	M
昌国	M
何伟	M
周彬	M
夏梦云	F
胡珍平	M
刘涛	M
李甫冬	M
邓琦	M
王德华	M
杨彬	M
李云艳	F
赵丽伟	F
高启兰	F
黄正芹	F
陈艳龙	M
彭星	F
边秋成	M
陈显通	M
林克文	M
王珏	M
戴玉	F
董佳楠	F
秦兴珠	F
谢巍	F
陶毅	M
周剑波	M
范哲栋	M
杨强	M
李萌	F
武旭敏	F
李兵兰	F
李亚锋	M
周磊	M
张晓静	F
李庆云	F
叶晶晶	F
姚大芬	F
郭润霖	M
董志恒	M
曹雪涛	M
穆书翰	M
李名芬	F
唐瑞雪	F
尹蕾琼	F
杨亿	F
张晗2	F
阮嘉露	F
韩宇	M
吕鑫	M
周士博	M
鲍锦雪	F
徐水根	M
赵言昌	M
刘丽刚	M
张骏	M
陈飞杰	M
周松根	M
侯增瑞	M
刘梦鑫	F
杨健	M
黄浦云	M
白伟伟	M
李锦	M
宋荣华	F
王帅	M
肖华兵	M
肖红刚	M
宣荣海	M
应斌湖	M
江燕	F
武明阳	M
周双虹	F
廖春红	F
聂华	M
邬承峰	M
熊四妹	F
刘国品	M
丁慧丽	F
涂勇强	M
袁仕玲	F
黄小蕾	F
沈良景	M
孙博	M
陈亚奇	M
刘叶亮	M
许天昊	M
高翔	M
单孙奎	M
王宗伟	M
李根义	M
李宽	M
沈明辉	M
胡鑫	M
陶勇	M
姚兵	F
梁颖	F
张湃	M
马沙巴乃	M
吴会娥	F
聂芹	F
高燕	F
董颖	M
胡广华	M
李舜锋	M
曹洋	M
王玉坚	M
袁铖	M
韩聪颖	F
谢珂婷	F
刘鹏	M
高月霞	F
胡久文	M
王晓峰	M
任美娟	F
方新丰	M
陈小波	M
李小燕	F
谯棵	M
贺家明	M
蔡培霞	F
刘玉花	F
方侨	F
曹忠喜	F
易国生	M
戴文杰	M
马浮豪	M
张国华	M
李聪	M
刘进英	F
朱磊	M
周雅	F
朱雪莹	F
杨志平	M
汪雅晴	F
蒋细萍	F
宁晓利	F
梁春红	F
田攀	M
李兴疆	M
韩明东	M
刘海红	F
伍周兵	M
吕莹	F
李洋	M
张大伟	M
宋明浩	M
林建明	M
孙金花	F
余泽成	M
陈芳均	M
张明珠	F
洪余	M
郭飞	M
徐胜	M
刘甫	M
陆伟	M
付清	F
郑耀楠	M
董雷	M
刘文萍	F
杨啸	M
王思琦	F
谭志凯	M
孙孟杰	M
虞磊	M
黄晓燕	F
吴阿棱	M
任曰绪	F
杜友	M
竺莉娜	F
涂晓洪	M
危兵	F
李玉忠	M
王融融	F
邬伟	M
袁伦友	M
张玲	F
王丽梅	F
阮维	M
王绍恒	M
范金玉	M
沈方文	M
王春玉	F
徐嘉婧	F
傅债估	M
戎雪燕	F
陈晓雪	F
吴东江	M
高希臣	M
孙廷武	M
沈毅	M
马家浙	F
刘涛	M
刘荣	F
汪德乐	M
徐颖颖	F
蔡伟峰	M
余朝阳	M
谢金玉	F
刘炎雷	M
王大武	M
韩冰艳	F
张飞	M
江微波	F
陈娜	F
何珠姑	M
卢明甫	M
赵海鹰	F
傅佳秀	F
王新文	M
王金伟	M
喻永丽	F
李健	M
李丽君	F
李其梅	F
谢彩凤	F
吴苗	F
王连成	M
姚普选	M
陈徐花	F
徐思文	F
李小女	F
李仙弟	M
田西乡	M
杨天花	F
郝苗苗	F
杨晶	M
罗会德	M
葛新琴	F
张立佳	F
鲍玉涛	M
陈大勇	M
吴岩辉	M
廖世威	M
熊良栋	M
刘燕娜	F
王娟	F
赵冬利	F
冶麻乃	M
江建春	F
徐征婷	F
吴文平	M
余细丁	F
廖正明	M
党云军	M
李雯玲	F
陈春淼	F
应小云	F
王培慧	F
王鑫磊	M
王枭敏	M
刘建国	M
曹珊珊	F
王琴	F
熊冉	M
易忠衍	M
张凯	M
李舰波	M
苏亚辉	M
唐远	M
耿学林	M
孙跃振	M
张进	M
陈伟文	M
王斌	M
王会征	M
王春艳	F
林彩莲	F
沈飞	M
李琦峰	M
夏婧	F
汤忠楼	M
陈宁建	M
范凯强	M
肖定良	M
杨旭	M
代元	M
王英豪	M
赵恒	M
侯丽	F
李辉	M
王少兵	M
王煌	M
梁龙	M
袁福顺	M
李波	M
冯站良	M
王小彬	M
王鑫	M
石小健	M
熊建国	M
沈肇萌	F
王国壮	M
宁虎	M
颜明聪	M
苏伟园	M
朱祥铮	M
王程磊	M
李松	M
许振宁	M
焦长江	M
王开思	F
李国令	M
李诚玉	M
汪卫东	M
路国权	M
吴仕杰	M
倪帅磊	M
杜娟	F
邢晨强	M
撒云才	M
何蒙杰	F
向明富	M
王丽媛	F
颜景旭	M
刘志财	M
徐煌	M
方美兰	F
韩相娟	F
索长明	M
黄瑞	M
续立洋	M
任崇璐	M
许兴豪	M
李磊	M
刘越洋	M
党伟望	M
田博文	M
韩秀秀	F
蒲应林	M
邹江	M
张爱霞	F
崔佳乐	M
尹彬	F
唐娟	F
郄海宇	M
李蒙蒙	F
李飞帆	F
陈莹2	F
徐海波	M
黎云霞	F
王隆	M
国府田祈实男	M
王俊青	M
金国君	M
雷毅	M
王烨	M
岳彩波	M
周清城	M
陆艳	F
郑吉祥	M
陈光锐	M
车来妹	F
葛春荣	F
代勇杰	M
潘显洋	M
赵润清	M
胡祥	M
王亚许	M
张晓珂	F
罗鑫洋	M
应佳行	M
康林坤	M
章艳芬	F
龚帅帅	M
董春雷	M
许梦蕾	F
陈志成	M
李伟	M
肖金顶	M
陈进龙	M
周敬敬	F
胡学琴	F
刘云	F
刘旭	M
吴华达	M
胡秋林	M
王俭	M
梁宇	F
周玲	F
丁军	M
谌小兵	M
李勇强	M
倪玉华	F
后玲	F
张叶	F
黄庆亮	M
易国强	M
杨尚	M
黄志康	M
黄金彪	M
孔德新	M
潘宁	M
张超	M
杨明骏	M
谢云祥	M
贺仁豪	M
吴有冯	F
李建军	M
刘丹	F
杨利民	M
徐金苹	F
何涛	M
汪莎莎	F
魏永艳	F
张建君	M
王立红	F
涂序汉	M
成文俊	M
王晨羽	F
张春光	M
苏玲	F
陶文秀	F
魏海静	F
吴卫星	F
张杰	M
丁贵洋	M
孙慧源	M
饶盛宇	M
杨旭辉	M
陈国平	M
郑久明	F
王智峰	M
吴幼铭	F
林萍	F
周煌彬	M
韩颖	F
李静	F
李晓动	M
吴碧滢	F
范辉见	M
韩盼龙	M
李密	M
刘小强	M
虞加娜	F
李芳华	M
万可可	M
沈鹏	M
陈洁	F
鲁璐梅	F
唐秋燕	F
王鹏举	M
于玲杰	F
胡兵兵	M
王胜伟	M
潘文智	M
史玉杰	M
汤广	M
方杰	M
林斌	M
黄红宁	M
徐礼杰	F
李虎	M
钱娜	F
刘志卿	M
刘守田	M
王立斌	M
朱小燕	F
王洪迪	M
胡恒超	M
李晓骏	M
黄万行	M
刘福同	M
董德超	M
杨先梅	F
任建新	M
崔建波	M
白韡	M
靳能兵	M
陈浩	M
王臣雨	M
聂秋兵	M
张芳	F
章维	M
孙格格	F
易思玲	F
王思情	F
宋丹	F
颜丽颖	F
范琳琳	F
王杰伦	M
陈传羽	M
杨小云	F
李源	M
郭素强	M
陈明检	M
Ahmedghonaim Khafagy	M
曹申奥	M
李丹	F
吴焕业	M
黄爱嫆	F
张国靖	F
曹澜旭	M
戴凤超	M
石书阳	M
寇国晶	F
王法社	M
姜甲乙	M
孔玉双	F
陈美洁	F
付志申	M
董翠玲	F
王乐楠	F
王代军	M
陈志兴	M
管红凯	M
赵欣	F
侯瑞雪	F
张雅倩	F
张明刚	M
赵四平	M
胡加宽	M
徐珊珊	F
陈家俊	M
臧飞飞	F
张爱国	M
陈伟	M
付彦伟	M
万英杰	M
张孝文	M
朱成程	M
朱凌	F
沈君琪	M
田向辉	M
林丽丽	F
吴事沙	M
张学志	M
夏水根	M
海志强	M
胡佩军	F
曾晓璐	F
罗子琛	M
陈金鹏	M
马有奴四	M
熊美勤	F
马江洲	M
何芳	F
许斌	M
庾昊	M
宁亮	M
王石林	F
翁亭	M
王哲	M
马永梅	F
何明程	M
陈友磊	M
王知恒	M
荣浩东	M
岳荣仁	F
贾宝莹	M
赵斌杰	M
张凡	M
王道进	M
熊平	M
刘福和	M
杨桂铜	M
曾建文	F
范露丽	F
王丽华	F
赵建辉	M
陶学栋	M
陈信源	M
段乐乐	M
刘雨嫣	F
张丙贵	M
倪献华	M
谭俭	M
邓家奎	M
覃智超	M
李垚	M
孟楠	F
沈镓妃	F
李鑫	M
胡耀明	M
潘小蒙	F
张勤恭	M
甘田甜	F
李东瑞	M
王振超	M
王正	M
何国飞	M
蔡广	M
苗旭乾	M
刘畅	M
范云云	F
刘伟	M
童露娜	F
王贺	M
张剑	M
屈天宇	M
宁方凯	M
范耀忠	M
杜保旗	M
王朋	M
李国伦	M
胡云祥	M
方红	M
邹东雨	F
刘艳	F
黄春根	M
王浩	M
王宁	M
梁崇靖	M
陈艳琴	F
张连奎	M
曹蔡强	M
温春艳	F
杨金勇	M
轩文龙	M
李义福	M
靳晓艳	F
程应春	M
陈忠才	M
安庆	M
聂海军	M
徐文卓	M
陈知力	M
张建军	M
刘一凡	M
黎蛟勇	M
马旭博	M
李智勇	M
王丽娟	F
杜贵荣	M
钟亚君	F
姚景	F
孟令辉	M
李国江	M
叶春丽	F
鲁绳亮	M
王仪明	M
陈善聪	M
沈振华	M
张兵	M
李超	M
陈培青	F
董袁袁	F
王怀标	M
熊竹青	M
韩雄	M
雷平平	M
彭升鸿	M
李颖琪	M
楚俊红	F
童琦	M
徐跃	M
王腾	M
彭浩	M
牛晓宾	M
陈明峰	M
李长江	M
李秀梅	F
王彦	M
周木芳	M
邵静	F
杨旭红	F
庄科云	M
刘昊	M
王惠萍	F
左小龙	M
卢保乐	M
张迪	M
刘文卓	M
王超	M
黄良生	M
黄云	M
何亚城	F
丰文凤	F
施爱兰	F
林旭	F
戴多加	F
杨涛	M
李亚萍	F
黄加平	M
柳建忠	M
宋慧明	M
徐四春	M
徐莹	F
裴静	F
曹圆圆	M
马红兵	M
范琦慧	F
吴龙香	F
王广坤	M
唐汉杨	M
卓勇	M
李兆东	M
陶茂胜	M
郑翠翠	F
陈彪	M
吕松茂	M
陈栋良	M
李琪	M
吴萍	F
李青桐	M
吴荣	M
刘鑫博	M
高国娟	F
周云	F
王奕骅	F
张均宝	F
王学禄	M
徐小清	M
李文斌	M
蔡林财	M
李祥叶	F
沈国英	F
陈燕	F
何意菊	F
李健	F
刘蓓	F
陈军明	M
陈南对	M
邓伟	M
刘兴奎	M
张贺平	F
吕秋良	M
李明	M
王伟	M
邱宾宾	M
周佳康	M
李凌磊	M
胡埜	M
马丽	F
刘永南	M
刘刚	M
陈国平	M
罗玉凤	F
陆茂盛	M
金珠琴	F
彭敏哲	M
张权才	M
胡小洪	M
陈利英	F
章文华	M
王江	M
段少有	M
许艳华	F
陈巧玲	F
李敏	F
周耀洪	M
杨娅南	F
王慧	F
贺雪梅	F
王慧明	F
魏群培	M
石君飞	F
沈克斌	M
丁继成	M
刘桐	F
傅利民	M
辛永琰	M
胡亚朋	M
胡林飞	M
徐子恒	M
公鑫媛	F
陈清满	M
李小龙	M
关丽平	F
严威强	M
宫鹤	M
张玮	F
王方玲	F
袁名辉	M
傅俞	M
李海涛	M
李曼丽	F
类雪	F
龚萍	F
李世军	M
朱玲玲	F
朱晨瑶	F
梁显友	M
梁和平	M
贾友帮	M
赵云	M
邢建宏	M
汪帮勇	M
张作旭	M
徐浩然	M
林智勇	M
崔立刚	M
许方文	M
王少龙	M
曾美	F
张兴文	M
张新伟	F
何雨晴	F
陶传伟	M
佘辉	M
曾强伟	M
魏青松	M
李棋	M
倪保建	M
王小英	F
刘敬飞	M
张璜	M
马荣波	M
高垒	M
王欣	F
陈任重	M
刘查查	M
高东波	M
熊方兵	M
秦宪	M
廖华钦	M
薛高登	M
韩金博	M
马全虎	M
李华能	M
刘鹏飞	M
兰俊杰	M
刘卿德	M
陈文豪	M
赵鹏飞	M
赵可可	M
刘召文	M
刘佳	F
严婵	F
刘靖园	M
潘娅	F
杨波	M
王文霞	F
聂轩	M
吴厅	M
甘子杰	M
邹军	M
龚进	M
章浩宇	M
丁道和	M
姜雨豪	M
段国胜	M
陈阿龙	M
周林平	F
付茂菊	F
高菊芬	F
朱晨露	F
朱自超	F
许新元	M
周燕佳	F
北川刚	M
计亮亮	M
金孝燕	F
严凤	F
林涛	M
张巧	F
李玲	F
朱丽颖	F
刘依	F
练泽维	M
吴精文	F
王婷	F
胡朝江	M
赵丽婷	F
兰震宏	M
吴斌	M
任必超	M
陈嘉烜	M
何三连	M
徐宇洁	F
陈学申	M
刘家祥	M
贺凤龙	M
朱鹏亚	M
刘节志	M
徐苗苗	F
舒召均	M
王佳辉	M
刘校乾	M
邱聪	M
王琦	M
洪子晟	M
钟文锋	M
曹潘凯	M
张义聪	M
熊卓松	M
冯有鹏	M
王成军	M
李贤	M
严辛垚	M
颜贻存	M
张健	M
王家文	M
齐行善	M
熊越	M
李云	F
张司勇	M
陈治勇	M
夏阿银	F
戴美珍	F
王梦瑶	F
肖淑豪	F
王静	F
马蕊	F
温春凤	F
黄云婷	F
韩佩佩	F
刘勋	M
顾光红	M
何芹	F
郭华庆	M
谢广岩	M
郑梦霞	F
余倩倩	F
刘瑞洪	M
刘漉涛	M
曹瑞	M
杨文聪	M
罗谢冬	M
许传明	M
刘凯	M
严林锋	M
廖远火	M
杨奋猛	M
麻旭亮	M
母文霞	F
顾太英	F
洪耀胜	M
周丹	F
张望胜	M
张利	M
李立成	M
杨学孟	M
朱冬冬	M
匡桂林	M
李华东	M
刘发	M
万冲冲	M
邱建朋	M
童剑	M
谢波	M
王安民	M
行海心	M
邓鹏	M
张得芬	M
贺梓轩	M
徐筱	M
徐家辉	M
陈英铭	M
杨龙华	M
汪俊	M
吴文豪	M
胡嘉星	M
刘保林	M
朱丹	F
周志然	F
赵红飞	F
马外西木	M
马旭杰	M
李朋梅	F
李阳俊	M
徐英	F
付豪	M
余嵩	M
蒲兆辉	F
胡三强	M
孟锦鹏	M
周轶凡	M
赵云	M
刘刚	M
孙秋珍	F
严娟	F
李宏伟	M
李水新	M
徐慧	F
柏林先	M
吕阳洪	M
崔广西	M
景梦	F
周云翔	M
宁柏林	M
王志鑫	M
魏朝辉	M
叶思芳	F
江景娟	F
钟阳	M
范友彬	M
江家庆	F
李修槽	M
张高亚	M
孟子尧	M
张乔丽	F
申红前	M
胡常娥	F
张秀丰	M
谌艳平	M
姜倩	F
张志毅	M
韩伟	M
易新林	M
何潇	F
王云玲	F
刘远贺	M
杜超	M
彭长辉	M
杨元翠	F
赵婧澜	F
马国斌	M
汤劲松	M
何炎艇	M
邓强	M
吴双杰	M
赵华刚	M
孙宋涛	M
马伟才	M
张浩	M
白海斌	M
石欣蕾	F
章丽庄	F
王志远	M
龚东飞	M
蒋绅	M
唐丁丁	F
谭良良	M
叶东升	M
罗长生	M
王朋磊	M
徐波	F
孔晶华	F
吴庆侠	M
张宁	F
张如超	M
张颖	F
王靖飞	M
季方	F
卢境远	M
曾杰	M
张尚东	M
桑小强	M
袁中华	M
谌凡凡	F
张亚南	M
刘孟秋	F
尹思莉	F
孔梦飞	M
胡岚博	M
赵冠西	M
周玉杰	M
程快乐	M
张换换	F
彭明慧	F
吴锡成	M
鲁晨辉	M
张旭	M
张元	F
宋振梅	F
胡鹏	M
郭晓航	M
蔡小利	M
黄凌	F
居彪	M
李宁	M
查卫斌	M
孙方贵	M
王盼盼	F
常振国	M
王丽鹃	F
王京伟	M
王世云	M
马小文	M
李胜利	M
黄岩	M
张雪杰	F
张子洋	M
邢旭	M
罗圹女	M
卜留记	M
黄东升	M
蔡书花	F
王丽娟	F
李金霞	F
张伟	M
虞吉明	M
黎超群	M
李运达	M
王琼	F
姜上生	M
方晓艳	F
李烨	M
王红旗	M
尚金良	M
张重	M
杨雷	M
王磊	M
吴发磊	M
邱志荣	M
冯显周	M
徐友兵	M
刘世同	M
杨博	M
金先松	M
马玉莲	F
闻慧萍	F
李来滨	M
李志强	M
王小小	M
张玉坤	M
许哲亮	M
赵德微	F
李莉	F
王会芹	F
郭书珍	F
周丽思	F
俞丽珍	F
魏厚志	M
刘倩倩	F
李井霞	F
胡春宝	M
李亚东	M
杨大海	M
王苗	F
王敏产	M
尹娟艳	F
张春奎	M
唐赐艳	F
朱先军	M
曹增辉	M
徐晓丽	F
杨帅领	M
曹晴	F
徐翔	M
李洪云	F
李双洁	F
赵涛	M
宋婼敏	F
樊奇宾	M
江航哲	M
杜秀桃	F
熊美	F
张晓星	F
胡俊昊	M
汪奉强	M
徐显东	M
张细英	F
董晓广	M
侯文超	M
邹剪花	F
黎德慧	F
芦英波	M
陈文兵	M
潘登	M
龚真真	M
丁朝梁	M
文海燕	F
王阳生	M
许晓敏	F
李茶	F
刘存	F
李金卒	F
江高洁	F
陈冲	M
付万有	M
张元瑞	M
王海月	F
邓羊	M
张冠华	M
侯宇	M
罗琳	F
沈晨晨	M
王海龙	M
郝银川	M
张胜	M
连芦敏	M
严秋菊	F
鲍银波	M
程送圆	M
李竞赛	F
汪小鑫	F
李家腾	M
张彦利	F
秦惠萍	F
张志强	M
刘善东	M
李武兴	M
曾吉源	M
蔡晓娜	F
唐晓华	M
王思维	F
秦后兰	F
王思翠	F
张雪杰	F
陈婷	F
赵子硕	M
陈开丽	F
张烨	F
孙黎明	M
王添琅	M
刘客客	M
王晓兰	F
范红梅	F
贺凯益	M
陈荣	F
夏秀平	F
杨齐国	M
杨春雨	F
吕京灵	M
张如	F
刘婷婷	F
丁冬梅	F
顾洪凯	M
马驰	M
周志学	M
夏浩	M
张宇	M
谭兴发	M
汤林凯	M
卢荣辉	M
翁彩霞	F
虞将	M
郑红雷	M
罗学敏	F
聂裕江	M
余金锋	M
李凯	M
陈宇翔	M
张成伟	M
王江	M
卫雪斌	M
罗义君	M
罗银玖	M
莫启国	M
边小燕	F
符斌杰	M
胡嘉艳	F
文力优	M
李庆玙	F
徐超	M
陈丽强	M
封智伟	M
王凯鑫	M
李洁	F
毛炼杰	M
徐琴琴	F
张安军	M
陈波	M
黄竞峰	M
毛国坪	M
补文华	M
周志豪	M
王晓晓	M
王聪	M
周友一	M
邱静蕾	F
张伟	M
王芳芳	F
蒋盛辉	M
冯小刚	M
邬露港	M
卢德云	M
李佳云	F
孙爱勤	F
陆训兰	F
余安乐	M
何思琪	F
王蝶	F
杨超武	M
陈艳	F
闫飞	M
许伟	F
黄劲松	M
李煜	M
张永平	M
董文胜	M
张骏	M
谢伟健	M
王立婷	F
李学风	M
周津	F
陈传伟	M
曾维	M
喻军荣	M
王琳炜	M
周洪兴	M
肖静妍	F
邱勇	M
岳艳芳	F
陆一凡	M
金佳霓	F
王伟杰	M
王静	F
张晓英	F
王武辉	M
俞雁	F
黎雪娟	F
刘力文	M
袁素强	M
张钦阳	M
祁咪咪	F
郭爱斌	M
叶洪	F
刘芳	F
苏龙龙	M
张敏	F
刘江华	F
杨威	M
张良军	M
邱颖孝	M
朱海圆	M
马小花	F
张薇	F
吴明强	M
吴万留	M
杨可旺	M
丁冰	F
吕征	M
谢建	M
刘先盛	M
周焱	M
张丹	F
张明	F
杨潍铭	M
杨煜	M
孙倩茹	F
余力	M
刘旭	F
汤寒笑	F
庾桦	M
杨艳芳	F
余丽	F
张鸣浩	M
袁芙	F
黄苏杭	F
丁奇强	M
叶平	M
张治良	M
郑红红	F
丁小红	F
王鲜艳	F
刘新宇	M
王巍巍	F
袁宜宜	M
李彦葶	F
李浩	M
丁二明	M
范文翰	M
洪磊	M
符继东	M
吴亚飞	M
王怡	F
杜昭钰	F
慕彦强	M
邵浠怡	F
杜珩	M
李飞	F
韩长乐	M
陈贵珍	M
景琛卓	M
陈文俊	M
刘新宇	M
孟海旺	M
王岐斌	M
王亚莹	F
俞烨焘	M
董宜	F
董润禄	M
彭艳荣	F
郑楚月	F
曹跃峰	M
孙倩	F
杨立勇	M
马昱	M
朱永洪	F
郭振强	M
刘兵	F
葛思宇	F
王洪芳	F
袁周军	M
周树杉	M
胡姚晴	F
饶建军	M
王二辉	M
苏祥云	M
徐亚振	M
齐航	M
刘建平	M
何丽荣	F
马哈牙	M
安志强	M
刘庆同	M
胡霄	M
马热黑木	M
刘从海	M
汪强	M
许建成	M
田丰源	M
鲍利华	M
何玉香	F
郭艳康	M
张秋瑾	F
吴继开	M
周代刚	M
李超	M
郑兴泽	M
李华香	M
侯杏仁	F
郑樟达	M
姚宝平	M
吴训江	M
王大伟	M
马启浪	M
李松	M
徐伟	M
吴建明	M
范文俊	M
杨金松	M
时维龙	M
徐仕涛	M
贺开	M
涂灵灵	F
袁亚兰	F
李冬琴	F
周斌	M
张智润	M
宋建锋	M
胡正果	M
何建鹏	M
周文灿	M
刘来弟	F
董建平	F
王瑞	M
周戈会	F
崔梦珂	F
黄荣文	M
王长平	M
徐浩	M
朱明月	F
毛慧情	F
刘金凤	F
赵雁	F
张静雯	F
熊美琪	F
罗土木	M
米鹏超	M
邱建功	M
王小波	F
严鑫	M
向桂英	F
吴林霞	F
曾忆齐	M
宋照凤	F
任玲玲	F
李奇林	M
吴二亮	M
张亚娜	F
王江金	M
王林燕	F
张伟林	M
章燕	F
董王莹	F
秦超	M
任冬竹	F
张玉娟	F
葛旗	M
赵朕	M
叶俊杰	M
温亚杰	M
胡益	M
朱晨曦	M
曹华进	M
吴志权	M
罗佳浩	M
邓永辉	M
周迦南	F
王秦	F
盛维英	F
夏浩	M
李果子	M
王亮亮	M
江世英	F
钟增林	M
刘世忠	M
吴志东	M
段元斌	M
温会斌	M
曾毓芳	F
曾思瑶	F
张合贵	M
廖金	M
张胜	M
黄垚	M
钟文杰	M
钟函宇	M
符亭	M
汤志胜	M
周文颖	F
王铁	M
王淑妍	F
梁晓鹏	M
汤晓丽	F
马丽丽	F
彭志怀	M
毛书俊	M
谭华清	M
王明	M
王忠斌	M
刘恒	M
严锦东	M
朱宝	M
兰江	M
孟祥年	M
李德明	M
张志源	M
徐刚	M
刘明文	M
阳怡广	M
李成军	M
廖鑫	F
唐荣	M
岳芩冰	F
田志康	M
汪靖松	M
郭玉芳	F
史迦勒	M
沈天宏	M
刘燕玲	F
余爱霞	F
蒙剑宽	M
潘婷	F
席雨欣	F
叶红利	F
毛圣国	M
徐云飞	M
谢秀娟	F
孙宝旺	M
李晓霞	F
顾志浩	M
陈梦凡	M
邹昊	M
周鑫林	M
喻泽政	M
邬洋	M
付文超	M
何亮	M
万启航	M
钟柔柔	F
黄雅萍	F
郭丹	F
胡豪	M
刘世泽	M
周鑫	M
侯俊	M
龙江	M
叶茂盛	M
刘明星	M
刘伟	M
赵志丰	M
罗吉强	M
熊世鸿	M
罗李	M
刘敏	M
王嘉宁	F
金辰雨	F
李延长	M
陈杨	M
张嘉吉	M
付润	M
吕晶	F
吴毓霞	F
邓方聪	F
龙林	M
王韬	M
罗军	M
郑巧依	F
肖纯	F
张连东	M
郭顺元	M
陈永超	M
周磊	M
黄晴光	M
张贤桌	M
杨阳	M
王红丽	F
刘静	F
郑海晓	F
林泽用	M
马军	M
陈浪屿	M
陈嘉林	M
杨朋	M
裘雨虹	F
胡婷懿	F
吕俊	M
陈晨	M
夏孝烽	M
余鹏鹏	M
熊云平	M
郑虹	F
邵向东	M
龚子昊	M
葛小丛	F
彭高军	M
张智蠢	M
王睿敏	M
夏兵发	M
胡清	M
宋会会	F
郑聪	F
朱敏	M
陈华	M
汪爱萌	F
陈贵生	M
周建新	M
张嘉祺	M
黄子娟	F
马清芳	F
余承斌	M
詹云鹏	M
苏有朋	M
陈萍	F
温志鹏	M
吕爱妙	F
王禹	M
宋泳锐	M
孙丹阳	F
涂梦灵	F
王慧彬	M
夏美雲	F
何阳	F
张展州	M
周小燕	F
肖尧	M
虞麟	M
顾问	M
安旭东	M
邓冬根	M
冯锦元	M
黎江健	M
王朝义	M
王子熊	M
胡鹏程	M
郭兵	M
徐强	M
张倩然	F
陈鹏	M
宣树仁	M
郭春波	M
吴琼	F
洪媛	F
毛光宇	M
姜开帅	M
顾华	F
齐梦阳	M
刘成	M
徐志波	M
罗兰	F
吴若冰	M
宋仁杰	M
刘博	M
孙文喆	M
侯绍成	M
徐爵	M
王忆惠	F
张美娟	F
罗小青	F
仇洪	M
何宏伟	M
杨天靖	M
彭兴	M
舒东	M
经律	M
施乐乐	M
胡丹	F
周欣欣	F
黄其萌	M
郝树宇	M
张伟	M
胡长江	M
钟成金	M
武威	M
武海崖	M
高嫚杰	F
刘佳瑜	F
李勇	M
段志程	M
陈萍	F
王卓	M
李强	M
肖学峰	M
李凯	M
刘燕丽	F
尹梅	F
苏展	M
钱萃水	M
李嘉敏	F
施婷婷	F
贺坚	M
石森豪	M
杨子华	M
郑梦玲	F
吴爽	F
邱小娟	F
胡自游	M
苗世林	M
贾永强	M
郭招兵	M
许丙皖	F
徐凯军	M
李微	F
胡海峰	M
彭显凯	M
何立萍	F
方彬	M
董红新	M
凌艳	F
黄锦田	M
周聪	M
王胜伦	M
黄文利	M
胡轶凡	M
黄开园	F
李婉迪	F
明月	F
杨胜英	F
杨波	M
伍勇	M
程桂香	F
陶昌华	F
徐春红	F
孔凤	F
吴黎峰	M
刘洋	M
朱艳秋	F
贾腾龙	M
王洋	M
秦耀龙	M
高轶伦	F
赵鑫鑫	M
周慧琳	F
王亚超	M
杨晓杰	M
朱敏	F
何光伦	M
彭艳丽	F
杨鹏	M
马法法	F
邓成江	M
胡美喆	M
倪志坚	F
陈晨	F
徐苗幼	M
李婕	F
吕志明	M
丁国刚	M
余文辉	M
刘清泉	M
马哈如你	M
张世雄	M
余江海	M
罗成	M
朱小兵	M
郭雪松	M
鲍攀贵	M
钱文龙	M
李珠	F
马梦雨	M
闫少聪	M
李新彤	M
杨兴刚	M
郑如琛	M
白保青	M
刘辉	F
凌家豪	M
谌建美	F
金斌斌	M
曹兰君	F
宗瑞花	F
徐依俐	F
熊婷	F
丁健平	M
易明阳	M
马成连	F
海军	M
梁娇	F
高利爽	F
李松松	M
庞思林	M
邱静	F
王勇	M
田敏	F
谢明亮	M
冉光飞	M
王超良	M
李志强	M
雷心	M
杨帅	M
妥兰花	F
罗青松	M
祝志强	M
温跃跃	M
祝新安	M
柯尊雄	M
张雪松	M
苗耀斌	M
何爱霞	F
未建财	M
沈玲英	F
苏雪雨	M
宗文正	M
许爱军	M
杨亚伟	M
李孟洁	F
赵海龙	M
欧阳文韬	M
张寿廷	M
靳宝术	M
郑文	F
李海楠	M
张翔	M
李建平	M
龙胜云	M
肖志海	M
尤博	M
石聪	F
俞周栋	M
汪云飞	M
杨萍	F
杨利强	M
李东妹	F
龙佳	F
陈彬	M
崔开来	M
祖宝	M
何星宇	M
严春娟	F
唐茹发	F
蔡齐惠	F
吴李娜	F
朱笑涵	M
楼盼盼	F
黄承荣	M
段红娟	F
朱朝榆	M
周红林	M
李家佳	F
朱元凯	M
杨坤	M
金娅廷	F
陈超	M
任菊香	F
蒋小雨	F
叶娇妍	F
汪丰	M
李晓	F
滕凯凯	M
陈斌	M
马卓颖	F
罗彩霞	F
滕辉	M
胡佳丹	F
王全	M
陈勇峰	M
周华鹏	M
姜雨晴	F
凌波	M
黄春路	M
刘思宇	F
陶键敏	F
周宇行	M
薛文静	F
班艳芬	F
胡娜	F
宋亮亮	M
马文龙	M
付士辉	F
刘一博	M
刘卓雅	F
宋俊	M
王刘聪	M
李国勇	M
常浩锋	M
李文碧	F
吴云英	F
马毅华	F
钱伟	M
胡向军	M
王文峰	M
张雨晴	F
孙雨芳	F
邱龙彪	M
徐鸿飞	M
赵镇	M
王小彬	M
张义华	M
姜志永	M
林帅兵	M
李康街	M
代强	M
张丽丽	F
张涌	F
叶丹凤	F
董春	M
王登奎	M
尤志林	M
戴兰苏	F
李昌瑞	M
戴尚国	M
吴维斌	M
邹最	M
黄加超	M
张耕	M
施珏	M
黄河	M
陆培培	F
宋新亚	F
青木尚彦	M
李新龙	M
葛威志	M
严敏	F
刘锦勇	M
陈金兰	F
张雪勤	F
胡风琴	F
孙文浩	M
杨丽梅	F
马彪	M
陈斌	M
黄钰	M
张会敢	M
王敬宇	M
宋庆伟	M
闫月星	M
谌美琴	F
金明明	M
陈星利	M
高颖	F
龚叶程	F
陈楠	F
胡远灿	M
姚志雄	M
王建坡	M
白武才	M
徐江云	M
张水浪	M
张学梅	F
马帅	M
刘江华	M
孙雨婷	F
隋任港	M
朱薇	F
周雨婷	F
叶博	M
张佳琪	F
吴州锋	M
李静	M
江文	M
董劲	M
余涛	M
林子仪	M
李枝雁	M
庞立华	M
万海明	M
罗佳俊	M
田海博	M
张丽娜	F
张晓晓	F
李杰	M
苏少明	M
宋忠琳	M
刘俊	M
付向山	M
赵森	M
于明格	F
代振珍	F
丁凤娟	F
张巧	M
陆裕群	F
和梦云	F
黎小松	M
潘秀脑	M
潘勇林	M
赵以锋	M
刘通	M
胡晶晶	F
吴佳承	M
朱烈喜	M
刘映健	M
陈清泉	M
康欢蓉	F
毕小波	M
王振献	M
姜静	F
陈杨梅	F
锁自军	M
曲德闯	M
罗涛	M
丛德心	M
成亚东	M
谢伟涛	M
钱志勇	M
吴磊	M
凌其瑞	F
张博	F
彭正伟	M
谢磊	M
李城彬	M
傅东锋	M
朱明伟	M
鲍考君	M
吴维举	M
戴凯亮	M
张银枝	F
邱景华	M
汪开明	M
周世鹏	M
胡国伟	M
周亚丽	F
王鑫	M
刘彬	M
李磊	M
张志远	M
朱小江	M
付明江	M
谢富宏	M
汤文元	F
高博	M
谢波	F
朱思妤	F
马志超	M
安广学	M
李兆祥	M
马国兴	M
赵清洁	F
谢国宇	M
王金霞	F
杨平荣	M
吴丽红	F
贾振化	F
裴召勇	M
李点东	M
周茹芳	F
韦智	M
虞佳开	M
周江波	M
王尚全	M
马聪颖	M
嵇文强	M
张浪	F
李海燕	F
徐倩	F
姚宝刚	M
张新峣	M
方鸿飞	M
邹子明	M
羌玉萍	F
彭娟	F
朱政	M
张伟伟	M
孔振家	M
陈晓威	M
刘红	F
谢璜	M
任亚军	M
雷文宝	M
国中银	M
谷成志	M
杨林辉	M
赵庆红	F
李富强	M
李望秋	M
唐欢秀	M
周琳	F
金慧	F
聂华	M
邢颖	F
鲁永乐	M
彭丽娜	F
余晓丹	F
吴艄行	M
刘维刚	M
刘锦	M
杨宇	M
单克军	M
贾建军	M
王思文	F
钟逸嘉	M
廖培宏	M
王静	M
应建宁	M
葛啸杰	M
闫星星	M
王晨霞	F
王金华	F
余军	M
朱敏	M
陈雅君	F
易群	F
黄丽君	F
陈卓	M
刘大江	M
田静	M
庞世杰	M
张存罗	M
应烨宏	M
向炳辰	M
杨家镇	M
宋文昊	M
吴伊颖	F
张慧敏	F
徐正坤	M
刘佳兵	M
李政宏	M
马阿利	F
吴晓庆	F
王春	M
熊林夕	F
丁聪尔	F
费思懿	F
林飞蕾	F
卢珊珊	F
项苗苗	F
蔡芳军	M
陈祖林	M
张成卫	M
田野	M
张航英	F
陈晓娟	F
刘威	M
顾宁	F
彭宇琴	F
夏新祥	M
黄开亚	M
刘志军	M
徐静婕	F
卞玉瑶	F
周文博	M
陈学梅	F
孙乃清	F
陈丹萍	F
高若涵	F
蒋丹琼	F
邹梦涵	F
华雯卿	F
徐小荣	M
喻老棚	M
夏宝利	M
刘意强	M
尤秀利	F
何方斌	M
印伟	M
撒彦满	M
李丽	F
吴昕妍	F
李晋远	M
何幸益	F
李青山	M
李晓庆	F
姚忠	M
包瑞龙	M
刘晓彤	F
房树新	F
王亮亮	M
王世昌	M
于澜涛	M
刘宁	F
陈燕飞	F
赖文飞	M
崔凯	M
谭孝斌	M
方姗姗	F
王果慕	M
马兴翠	F
王萍	F
向超	M
李辉辉	M
赵雨点	M
陈倩霞	F
谢欣	F
张磊	M
邓兴艳	F
张晋泉	M
戴礼慧	F
刘月香	F
欧阳新辉	M
邓玲	F
朱小波	M
马红梅	F
赵星梅	F
杨滔	M
裘若莹	F
高兴阳	M
郑琳慧	F
张明	M
潘宇	M
尤晓丽	F
段冰蕊	F
龙昌秀	F
薛师秀	F
邓俊良	M
黄旭	F
张周果	M
孙跃斌	M
黄红涛	M
尹中天	M
张昆	M
单穗	F
邓德彬	M
王松林	M
鲁术明	M
曾胜奎	M
刘昌桃	M
王慧红	F
王立英	F
孙佳欣	F
李卫芹	F
田乾虎	M
王围	M
靳中晓	M
杨学忠	M
沈宇亮	M
刘勇刚	M
辛高峰	M
盛柯杰	M
李小波	M
王进	M
周涛	M
陈雪	F
王雄兵	M
李超邻	M
任业祺	M
李卫祥	M
陈吉	M
肖悟天	M
胡南燕	F
赵凯	M
韩友梅	F
吕鸯鸯	F
陈科峰	M
范永利	M
沈涛	M
丁浩歌	M
康丽鸽	F
朱俊焕	F
张孝青	F
何佳	F
胡天哲	M
赵临波	F
付思源	F
周圆圆	F
周旭	M
李玉华	M
高文君	F
王金成	M
王洋洋	M
李林英	M
陈晖	M
任非凡	M
万坤	M
叶俞希	F
沈美华	F
张坤	M
李小娜	F
虎桂珍	M
黄伟	M
苏玲	F
董国锋	M
蔡春鹏	M
王世伟	M
冀振男	M
贠盛韬	M
王铃科	F
朱宁霞	F
张继锦	M
王晓东	M
杨娇	F
陈存新	M
刘姣姣	F
罗威	M
何周杰	M
杨帆	M
张瀛	M
张鑫巧	F
胡云娟	F
孙建文	M
袁佳丽	F
王新贤	F
俞淑倩	F
刘依林	M
常曦斓	F
褚乐怡	F
彭银花	F
邵秀	F
彭亚平	F
刘金国	M
董世纪	M
肖代财	M
章晓宁	M
朱洲洲	M
王成晨	M
沈华平	M
刘佳	F
许如亚	M
陈笑笑	F
王林	M
李爱华	F
诸铭	F
杨晗	M
张春林	M
孙波	M
姚足	M
王梓幸	F
李自权	M
栗自家	M
刘士丹	M
孙悦	F
张挺	M
肖冬发	M
熊秋玲	F
杨欢	F
葛明亮	M
苏馨	F
杨汉飞	F
刘烨松	M
徐勤	F
谢成刚	M
贝伟军	M
张婷	F
吴晨颖	F
肖廷标	M
钱泽鹏	M
马玉俊	M
李大柱	M
赵琳	F
万菊花	F
齐龙云	F
张伟	M
秦天	M
胡泽楠	F
韩坤	F
胡存鑫	M
刘宝凤	F
董筱霞	F
马全会子	F
贺鹏	M
王明超	M
周娜	F
董莉维	F
张玮	F
杨靖男	M
陈英	F
郑恒	M
王维	F
王佳辉	F
张科	M
李瑞峰	M
幸荣贵	M
张艳云	F
吴新余	F
徐学勤	F
刘雪源	F
黄丽琴	F
谢英	F
岳怀忠	M
陈芳芳	F
李春丽	F
刘淑娟	F
顾姗姗	F
王丹宁	F
刘金龙	M
郝冉	M
吕燕红	F
武帅	M
蔡志超	M
黄志刚	M
刘若婵	F
刘红丹	F
黄凌佳	F
李美婷	F
朱家辉	M
程飞	M
尚微微	F
沈文彬	M
朱杰	M
杨维华	F
于地委	M
张代红	M
兰东森	M
段晓丽	M
涂玉霖	F
韩晓伟	F
万川	M
王跃	M
孙翠平	F
陈楠霞	F
项娴婷	F
余淑敏	F
王楚雯	F
徐利菲	F
项发波	M
蒲送庆	M
危苏芳	F
王学鹏	M
王天祥	M
万振涛	M
王晨飞	M
吴志鑫	M
刘祥	M
钱鸽	F
杨飞莲	F
马涛	M
张进红	M
刘亚琴	F
袁梦奇	M
何进	M
刘英	F
刘瑞阳	M
朱道发	M
张凯	M
朱轲轲	F
郭银梅	F
鲍露露	F
李熊	M
钟浪	M
师玉洁	F
别威	M
张春静	F
李小萌	F
胡少伟	M
何光发	M
廖菊莲	F
王冰2	M
徐藜宁	F
赵超飞	M
胡开群	F
郑江南	F
曹晶晶	F
茹姝慧	F
王莹2	F
王诗雯	F
李月欢	F
宋艳明	M
张怀铎	M
杨哲雪	F
李久洲	M
龚思容	F
李颖	F
徐莹	F
陈玮	F
陈军	M
潘艺	F
徐哲忆	F
耿琛	M
管梅芹	F
朱可鑫	F
徐佳洁	F
龙秀菊	F
王露英	F
马晨莞	F
褚杨炳	F
黄建伟	M
艾科明	M
许立明	M
吕磊	M
全唯浩	M
江倩倩	F
王二永	M
吕仲浩	M
欧阳建梅	F
韩思雨	F
孙玉宝	F
蒋丽娜	F
张宝虎	M
郝森森	F
于蕾	F
任艳丽	F
侯丹妮	F
朱钦佩	F
冯燕	F
董国民	M
朱萍	F
蔡艳杰	F
刘璇	M
傅倩芸	F
庄可馨	F
徐城城	M
郑俐	F
唐巍	M
刘新媛	F
关新云	F
何文成	M
杨飘	M
靳亭亭	F
汤书根	M
刘少帅	M
张乃宁	F
李小圈	F
郭金忠	M
钱俊芳	F
张学军	M
温广哲	M
王文丽	F
赵俊	F
雷富强	M
李西山	M
刘宁	M
杜卫康	M
王亚东	M
杨玉洁	F
方法娣	F
张昀	M
虞祝年	M
李丽玲	F
钱诗怡	F
陈伊楠	F
王丽丽	F
项阳阳	F
胡红梅	F
包洋菘	M
陈璐	M
吴雪飘	F
洪盈盈	F
徐夏楠	F
吴玉梅	F
聂涛	M
蒋丹妮	F
袁梦	F
叶倩霞	F
戴高琛	M
钱小菲	F
马杉杉	F
厉霞	F
王玲娜	F
陈巧玲2	F
敖艳	F
陈笑笑	F
施滢滢	F
张关关	F
朱宁	F
周丹妮	F
余建龙	M
顾冬科	M
王露	F
麻煜昱	F
盛振威	M
齐桂珠	F
贾培昱	F
黄艳晶	F
任海燕	F
李宗杰	M
汪洋	F
麻婉莹	F
杨佳妮	F
张紫云	F
竺萍园	F
魏居政	M
柳怀兰	F
黄晨毅	M
冯果夫	M
杨佩华	F
张智晖	M
张伟婷	F
叶海英	F
周浩	M
杜鑫杰	M
秦稳	M
朱亮	M
杨晨	M
陈苏	F
林国游	M
刘志澳	M
彭勉	M
薛咪	F
袁娟娜	F
余成诚	M
刘柯滢	F
姜贺红	F
沐春花	F
洪梦雨	M
刘志强	M
时康哲	M
李彬源	M
阳涛	M
张薇	F
郝文辉	M
林明桥	M
熊山林	M
谢嘉慧	F
谭积旺	M
周焰	F
张路云	F
肖琦	M
丁波	M
黄珊珊	F
潘海云	F
刘申扬	M
林旭	M
张星雨	F
邢方舟	F
吴欣赟	F
许梦婷	F
卢鹏	M
万义龙	M
林晓娜	F
张海涛	M
荣磊	M
邹鑫	M
杨召弟	F
巢元新	M
宗在华	M
汪赛妮	F
余柏	M
何迪英	F
陈永斌	M
李鹏	M
胡益品	M
陈校艳	F
白浩阶	F
王凯旋	M
周金声	M
李万华	M
傅春燕	F
朱培芸	F
崔丽	F
潘恩飞	F
郭志强	M
梁宁波	M
过金铭	F
王宁	F
巨宇星	M
卢朝川	M
杨广彦	M
黄琪	F
丁永民	M
李泽豫	M
李宛蓉	F
庄海华	M
张瑜	F
吴昌文	M
翁明海	M
陶加锐	M
黄在兴	M
顾璐珊	F
蓝芳	F
方芳	F
黄海琼	F
张兴财	M
胡海宁	F
冶强	M
李天星	M
章涛	M
张烨	M
王涛	M
张华	F
李檸池	F
刘军	M
闫雨	F
陈邦孟	M
胡公程	M
聂安安	M
毛阿健	M
华七巧	F
杨小龙	M
王兴富	M
郑思佳	F
段翰霖	M
高垚攀	F
楼浙燕	F
雷磊	M
杜超奇	M
杜杰	M
关龙龙	M
刘斌峰	M
刘瀚轩	M
顾越飞	M
范延晓	F
张明川	M
李传宁	M
贺梦婷	F
盛坤鹏	M
周向荣	M
何彧	M
尹保丽	F
雷梅梅	F
杨鑫宇	M
赖后峰	M
肖泽湘	M
仇颖超	F
丁圣辉	M
蔡虎子	M
魏保伟	M
杨璐	M
李宗明	M
曾艺宏	M
吴志伟	M
赵学雷	M
朱腾飞	M
赵浩辉	M
王繁	M
陈凯	M
陈明姿	F
胡晓龙	M
李晓南	F
王啸	M
韩萌菲	F
王淑	F
张安云	F
江慧	F
王汉唐	M
鲁新宇	M
黄来	M
孙政	M
孙江	M
杨清清	F
王岩岩	M
雷莉莉	F
叶晓敏	F
李滨	M
赵远航	M
钟清华	M
卜慧萌	F
董飞英	F
顾学章	M
石财宝	M
刘芸芸	F
王晓新	M
周瑞雪	F
徐宇超	M
罗晓境	F
李松	M
薛存强	M
朱俊伟	M
梁濮	M
朱淑婕	F
刘洪飞	F
周红洋	F
李风玲	F
吴三军	M
陈嘉静	F
祝星	F
杨娟	F
明颖	F
李凡	M
顾佳庆	M
黄丽丽	F
冷雪	M
邬亚辉	M
杨巨沁	M
黄旭军	M
王肖琛	F
廖晋楠	F
杨松	M
季锦涛	M
郑谦	M
姚明明	M
冯梦梦	F
张新林	F
陈枝	F
卢易	F
寇万堂	M
王干	M
翟彩飞	F
龚燕萍	F
王正光	M
钱新兴	M
宁平	M
吴冕	F
万诗萍	F
李广成	M
俞瑜	F
蒲国渊	M
肖雪琴	F
仝晓东	M
王小艳	F
王博研	M
杨凯	M
秦世龙	M
彭聪	M
黄海燕	F
陈洪霞	F
曹敏	F
李自军	F
邓招聪	M
徐金枝	F
胡楚奕	F
尤警航	M
何秋玲	F
周文	F
王友	M
韦德志	M
张南南	M
徐伟翔	M
张雪琪	F
周夏婷	F
丁水凤	F
岑天晨	M
王鹏程	M
向进华	M
郭会启	M
周可祥	M
赵建霞	F
李明会	F
童国光	M
白硕	M
李傲冬	M
王艳梅	F
郭志保	M
高怡然	F
苏英丽	F
王驰	M
王德武	M
尹健	M
练军科	M
叶煜晨	M
胡静霞	F
韦益	M
李莹敏	F
胡雪兵	M
沈伟杰	M
毕诗怡	F
董怡婷	F
陈信蓉	F
于志勇	M
田巧	F
李春辉	M
兰加芬	F
夏远	M
肖益勇	M
彭智	M
夏治新	M
汪佳	M
高远	M
陈海琨	M
马约花	F
舒小妹	F
李红均	M
冯建国	M
李秋红	M
王李旭	M
黄梦兰	F
程功	M
马健	M
后亚飞	M
孙好祥	M
牟祖栋	M
周珊珊	F
豆红奎	M
郑喆	M
齐爱芬	F
杨丽丽	F
李东升	M
邵争光	M
阚敦俊	F
童玉萍	F
孙佳正	M
王春草	F
刘幸	M
刘战	M
庞社豪	M
文楚阳	M
张宇航	M
吕晓敏	F
贺军召	M
杨涛	M
夏达	M
魏佳丽	F
戴书云	F
王雯婷	F
松井敬三	M
徐代权	M
艾鹏程	M
钟友兰	F
林诗雨	F
王玲	F
古向杰	M
刘娇阳	F
蒋标标	M
黄昊成	M
马秀秀	F
李经赢	M
欧阳华超	M
余瑞月	F
曹道霞	F
方萍	F
翁章辉	M
蒋会鹏	M
陆帅坤	M
曾子飞	M
邹威	M
刘勇	M
刘娜	F
曲昭宇	M
陈赵军	M
阳洁	F
王正杰	M
李亚鹏	M
丁爱红	F
张晨辉	M
耿鑫	M
吴焱燕	F
葛超	M
唐云	M
尹春梅	F
林露	F
阳贞	F
虞婷	F
王林冲	M
旦礼红	M
周玉芳	F
翁林辉	M
钟婷	F
王淑薇	F
王晓薇	F
刘士一	M
卢寒冰	M
王珍珠	F
朱佳良	M
郭欣	M
罗通	M
王福喜	M
李豪	M
丛玉雪	F
许美丽	F
聂思群	F
伍莹莹	F
刘付成	M
王超杰	M
施冉艳	F
高杨	F
张雪儿	F
侯君珂	F
杨璐	F
张龙	M
关英	M
杨志刚	M
计运卓	M
张艳瑞	F
韦宇迪	F
余斌	M
丁伟枫	M
蔡红亮	M
胡泽静	F
俞京	M
杨倩倩	F
周帅毅	M
范斗斗	M
袁柱	M
王玉龙	M
张晟明	M
寿先达	M
王泽洪	M
王明秋	F
夏忠楠	F
吕雪英	F
马喜明	M
陶泽慧	F
张振洋	M
刘晨鹏	M
王玲玲	F
瞿洪广	M
徐宵圆	F
董沛阳	M
阚宏达	M
翁斌辉	M
王梦思	F
池俊明	M
张伟	M
丁琴	F
徐红梅	F
雷亮	M
王朝	M
彭凯伦	M
张梦	F
鲁译鸿	F
李帘	M
吴文博	F
张世南	M
牟红琼	F
岑蕾	F
蔡斯玲	F
迟贵臣	M
袁瑞峰	M
涂海丽	F
崔雅惠	F
王梅晓	F
王泽思	F
姚杨鑫	M
陶仙霞	F
应志奇	M
龙城	M
万旭波	M
付绕	M
唐太喜	M
张心原	M
刘京	M
邱壮壮	M
刘超	M
黄光伟	M
袁成果	M
蒲雪莲	F
张浩然	M
高思雅	F
张小甜	F
王赋睿	F
陈璐	F
吴博才	M
胡亚鹏	M
汪升	M
王双川	M
徐忠韬	M
祝建勋	M
李丽丽	F
刘冰	M
李伟娜	F
付松	M
周晓亚	M
钟毅	M
吕俊杰	M
蔡志娟	F
陈邦晟	M
舒亚丽	F
梅超	M
王超	M
冯胜波	M
张吉刚	M
魏世浩	M
陈恩婷	F
康巧儿	F
卢江兴	M
张超	M
侯泽记	M
陈龙龙	M
吴显斌	M
龙英杰	M
黄淑军	M
卜玲玲	F
李翰群	M
黄金凯	M
肖婉怡	F
王军	M
罗晟	M
高迪	M
甘依平	F
张家源	M
华小英	F
王海峰	M
陆培亮	M
胡亚君	F
王吴星	M
胡本	M
王晴晴	F
王文洁	M
李留生	M
陈舒悦	M
宋余淋	F
鲁广	M
杨莉芳	F
娄本岭	M
邓海宝	M
马佩雄	M
王晓辉	M
谢雨晨	M
高锴月	F
胡莉	F
刘高发	M
陈鸯琪	F
熊浩	M
李玥瑶	F
朱家一	F
张晔	F
尤灿	M
黄长宏	M
王栋维	M
鲍霖	M
宋雪峰	M
曹闫	M
陈赛斐	F
孙敏	M
文良	M
周宇婷	F
李宇升	M
胡钦觉	F
张有萍	F
李娜琦	F
朱波涛	M
常钟奎	M
冯穆林	M
梁燕香	F
夏国忠	M
平世奇	M
张书瑞	F
宋赣海	M
鲍豪杰	M
陈宇杰	M
储梦霞	F
邬沁源	F
张庆港	M
李浩	M
于梦婷	F
李振祖	M
华悦	F
吴利富	M
车世畅	M
张雨亚	F
王之珂	F
徐国伟	M
芮绍伟	M
许新丽	F
卢辛拓	M
夏燕	F
邵熹	M
马忠梁	M
易新胜	F
林柳弘	F
马婷婷	F
朱泽斌	M
靳颖颖	F
李煜皓	M
郑宏蕾	M
邬轩皓	M
高鹏艳	F
姜克辉	M
伍伟	M
徐梦婷	F
张恺祯	F
陈兴玉	M
王爱军	M
熊礼堂	M
张天伟	M
白瑾浩	M
刘林	M
陆丹莹	F
林小荣	M
章祖晗	F
高雯雯	F
王子阳	M
李鑫	M
李小群	F
熊广英	F
薛晶	M
胡明进	M
马红	M
谭诗玉	F
边兆阳	M
夏良清	M
徐爱博	M
韩春	M
智亮	M
蔡海峰	M
吕游	F
刘佳文	M
戴瑞	F
郭建平	M
王健	M
徐佳杰	M
余嘉欣	F
徐栋	M
饶伟丽	M
张星	M
汪义赢	M
简泽俊	M
李莹	F
高垚莉	F
张盼拉	F
郭张勇	M
傅永华	M
潘勇	M
陶现文	M
徐志明	M
肖凯杰	M
刘自飞	F
王晓驰	M
洪轲华	M
张娟	F
李雄飞	M
叶夏彤	M
王灿辉	M
常影	F
刘晓	M
秦国燕	F
崔益波	F
刘燕	F
贺平	F
王福燕	F
文光和	M
林鹏	M
齐澳	M
唐路平	F
黄妤婕	F
祁秀明	F
刘伟斌	M
陈雨洁	F
姚思忆	F
赵李艳	F
蒙博	M
蒋彬	M
杨龙	M
代明旭	F
熊少扬	M
任长远	M
胡佳钦	F
陶霞	F
陶学成	M
翁慧婷	F
卢千千	F
俞建乔	M
艾锦球	M
易希	F
宋小清	F
丁征宇	M
刘清	M
徐祖斌	M
吴媛媛	F
丁家豪	M
吴楚文	F
胡晨曦	M
陈玉艳	F
黄虹珍	F
尚旭静	F
毛乐	M
胡秋玲	F
冯敏	F
王泽	M
郑常勇	M
赵鹏	M
何运翠	F
王海燕	F
林允勤	M
刘全波	M
陈兴飞	M
段浩然	M
林德旺	M
杨朋磊	M
周琦	F
姜勤	M
向辉	M
谢启豪	M
彭雨萱	F
方倩莹	F
陈艳萍	F
李霞	F
王建瑜	F
刘璐	F
张巧丹	F
孙宜	F
杜远红	F
游泽慧	F
华文杰	M
陈成	M
熊芳琴	F
夏永鑫	M
池德地	M
张频	F
李宜盛	F
陈馨	F
鄢迎澳	M
徐志根	M
舒信博	M
关秋雨	F
王毅明	M
宋荣基	M
史建华	M
彭采华	F
王玲飞	F
阮文恒	F
何婷	F
仇静龙	M
孟松	M
曹昌维	M
杨成昆	M
管小凤	F
唐坤兵	M
秦启凡	M
秦传国	M
张敏敏	F
王红如	F
李丹	F
雷佳慧	F
王越	F
钟瑜	M
万良彪	M
尹柏渠	M
刘兴	M
余超群	F
严丰	M
曹小敏	F
曹海风	M
黄广富	M
郝卫芳	F
胡烜龙	M
彭本松	M
罗细外	F
高永恩	M
郭鑫	M
蔡熹	M
张宁妍	F
苏科宇	M
张志坚	M
方长顺	M
彭琪	F
黎睿康	M
蒋新龙	M
周程	M
刘辉	M
曹霸濒	M
马金国	M
刘镜	M
姚仕成	M
张涛	M
段新宇	M
苏闯	M
潘吉俊	M
杨林建	M
张康清	F
童卫城	M
王帅	M
严乐	M
王磊	M
马煦东	M
孙文龙	M
曹杨	M
谈雅茹	F
朱显光	M
冯帅彬	M
罗玉华	F
何宁海	M
戢霞	F
吴晗	M
侯利财	M
付蒙	M
郑小松	F
杨兴成	M
熊毅	M
张云	M
李卡	M
王谱	M
常李瑞	M
方志君	M
陈子润	M
李艳娜	F
王志惠	F
李炳谕	M
何宣廷	M
严银露	F
王运强	M
周艺彤	F
付志远	M
张飞杰	M
林伟杰	M
崔绍威	M
和学智	M
张世锋	M
贾志坚	M
杨斌琪	M
项建伟	M
杨佳易	M
胡仁煌	M
刘玉靖	M
徐蓓	F
汪向杰	M
杨渝崟	F
董笑笑	F
何兴粉	F
王国华	M
夏细细	F
夏多多	F
付宗远	M
全刚	M
李贤	M
覃梅	F
陶表忠	M
田梦慧	M
姚群	F
周强	M
闫大玉	M
高云飞	F
杨晨璐	M
李秋华	M
杨勉龙	M
万明东	M
郭宇轩	F
向宇光	M
卢艳军	M
张见利	M
蔡颖颖	F
童定芳	F
李华琴	F
刘兵	M
李佳洋	M
赵浩男	M
陈科栋	M
郑飞飞	F
刘宁宁	M
陈钧剑	M
魏征	M
钱凯	M
沈银全	M
唐群杰	M
张启勋	M
包杰	M
李林	M
朱天乐	M
李鑫	F
范瑞媛	F
段晓楠	F
林洪祥	M
徐恒	M
苟苗苗	M
韦健	M
孙书拳	M
聂琴	F
杨顺苟	M
刘迷娟	F
董志辉	M
朱学涛	M
周新国	M
俞旭	M
祖恩学	M
朱勇强	M
伍松	M
涂为平	F
李志建	M
马军伟	M
陈嘉辉	M
马浪	M
荆胖胖	M
肖周	M
薛健	M
郝一潇	M
马振飞	M
杨瑞莹	F
刘文建	M
闫瑞丰	M
华慧菊	F
郑辉	M
邹剑峰	M
马智岗	M
马芳	F
芮燕	F
翟大祥	M
郑金科	M
杨娟	F
高亮	M
乔俊利	M
任智东	M
杨焱	M
伍晨益	M
陈东	M
朱观培	M
范冰	M
秦宇成	M
余斌	M
张旭琴	F
许文杰	M
徐鹏	M
徐亚辉	M
沙凡	M
蒋振飞	M
李理科	M
常振	M
黄航凯	M
田小利	F
何传波	M
骆辉	M
鲁珊珊	M
王显龙	M
蒋伟超	M
虞岚清	F
董治彬	M
李贞梦	F
王巧玲	F
王蕊蕊	F
仝博	F
张瑜	F
郭艳娟	F
彭建资	M
夏祖丽	F
赵腾飞	M
董龙权	M
杨培培	M
董威	M
周林	M
李景鹏	M
王迎秋	F
谭建贤	M
陈太平	M
余蕊	F
马哈直热	F
李贵荣	M
丁超荣	M
李硕	F
陈亚科	M
王童	M
高擎	M
李强军	M
周宇	M
吴晓飞	M
娄亚彬	M
刘锋	M
王开华	M
邹紫鹏	M
陈林	M
赖玉浩	M
李果	M
杨明义	M
李娜歌	F
杨红虎	M
王颖	F
缪志娟	F
邢丽平	F
苏哲	M
庄磊泽	M
苏宸毅	M
冯栖	F
祝佳萍	F
龚正瑶	F
高琳	F
王小明	M
邓陞恒	M
李春霞	F
钱厨房	F
陈志颖	F
黄声萍	F
孙继业	M
彭伦	M
沈静	F
刘忠幸	M
尹碧	M
韩光庭	M
吕琴	F
戴欣池	M
张剑杰	M
王焜	M
朱梦如	F
张彦栋	M
许佳琴	F
胡旭	M
武浩	M
胡由弟	M
吴波	M
聂云	F
商竹贤	F
韩得霄	M
丁汕汕	M
程雨濛	F
陈娟	F
田钧	M
刘凤丽	F
朱周琳	F
柳宏图	M
吕美高	M
吴云展	M
彭军	M
何宗凡	M
王志文	M
龙慧敏	F
刘祚辉	M
胡亚峰	M
兰加强	M
杨园园	F
陆居朝	M
吴博悦	M
夏青海	M
金节秀	F
杨晋文	M
陈越强	M
王云鹏	M
薛永金	M
范子卿	M
龚伊敏	F
潘恩杰	M
赵文丽	F
闵艳飞	F
吴浩伟	M
李冬冬	M
禹华熙	M
张徐杰	M
朱传建	M
冶有彬	M
王雨棽	M
郑莉婷	F
郑厉琦	M
程义徽	M
马有栋	M
李星辰	M
孙琪琪	F
陆达亿	M
张燕红	F
文阁玲	F
李恒鑫	M
邢天一	M
赵维丹	M
肖磊	M
陈宏杰	M
朱琳	F
白洪志	M
黄兆晨	M
蒋晓华	F
孙基奋	F
诸瑶	F
金胜锦	M
罗冬利	F
侯佳璐	F
刘一夫	M
张莉	F
段中帅	M
叶雯菲	F
黄文龙	M
付小珍	F
唐雪莲	F
刘秀	F
李徐	M
赵玉群	M
徐铁兵	M
夏子锐	M
许敏	F
项时庆	M
马晓杰	M
马馨雨	F
田杨洋	M
高爽	F
陈俊男	F
张杭	M
周玥	F
王梦真	F
王振强	M
张标	M
陈阳	M
杨春敏	M
张鹏远	M
王卓然	M
阮昊	M
张灿	F
王春焰	M
程红	F
贺飞燕	F
潘佰华	M
邹海蓉	F
范方立	M
沈晓盛	M
陈荣节	M
张来华	M
王洪赞	M
李君	F
温楠	M
裘芳惠	F
陈悦	F
李佳琴	F
吕思瑶	F
屠沈莉	F
蒋光荣	M
尹修友	M
何海	M
周鹏飞	M
陈荣荣	F
王亚婷	F
杨金平	M
邵兴	M
陈晓燕	F
夏静	F
张汝安	M
王佳杰	M
董正中	M
楼燕	F
徐林康	M
王伟超	M
马亮	M
刘浩峰	M
管伟思	M
曾宪伟	M
徐莉琴	F
魏显显	M
国宏	M
李文青	F
马凤平	M
马梯	M
王远博	M
殷涛	M
李清	F
张振	M
张智	M
胡新鹏	M
徐宁	F
朱文炳	M
朱瑞瑞	F
周正	M
徐雨阳	M
黄勇	M
褚佳男	M
胡志文	M
张乘源	M
穆亚林	M
张泽华	M
韩亚	M
李正世	M
陈阳	M
汪元凯	M
徐斌	M
周娜	F
许文可	M
迟殿宁	M
陈赛赛	F
李靖	M
崔成辽	M
聂文涛	M
黄磊	M
刘艺	F
顾正洲	M
陆定越	M
束龙友	M
黄恒	M
韩劼成	M
孙义文	M
陈鑫	F
于振宇	M
史卓婷	F
王树豪	M
佘小菊	F
吴星刚	M
胡丽	F
杨迎	F
武文秀	F
周乾森	M
周磊	M
李勋	M
张飞飞	F
屈文超	M
胡黄莉	F
张姝赟	F
邢勤勇	M
张准	M
郑娟	F
朱文韬	M
武晨	M
柯莉红	F
丁晨明	M
卢登朝	M
赵先荣	M
赵顺刚	M
周春珍	F
唐勤勇	M
胡小春	M
张法荣	F
于海龙	M
王济环	M
李慧斌	M
吴权晋	M
张森森	M
宋家	M
胡新亚	M
黎庆荣	M
李倩倩	F
李佰树	M
戴西斌	M
何文飞	M
成良龙	M
吴亿田	F
顾铭扬	M
张天宇	M
魏文文	M
冯才华	F
曹霖	M
王悦	F
张涛	M
王斌	M
朱佳媛	F
刘超	M
王旭	M
吴增增	M
林振旭	M
沈旺	M
吴琬	F
王小婷	F
张裕荣	F
罗苏杭	M
严慧黠	F
陈世柱	M
谢彬	M
乔玉美	F
周佳辉	M
程瑶	F
宋艳爽	F
李明哲	M
周腾远	M
李懿琼	F
向发立	M
陈少聪	M
张鑫	M
潘海洛	M
夏强伟	M
王绿叶	F
邹梦芝	F
马景山	M
曾凡芬	F
刘亮	M
陈新	M
沈穆炜	F
蒋群超	M
刘威	M
李超	M
邹梅	F
丁文秀	F
李钫丹	F
熊雪琴	F
王啸娟	F
王东升	M
罗大英	F
蒋元宇	M
华婷婷	F
昌勤亮	M
周铭明	M
肖杰斌	M
管亚鑫	M
宁福泽	M
刘艳波	M
汪洋	F
潘婷	F
叶何立	M
张方远	M
张国庆	M
潘勇	M
仝祎峰	M
马双艳	F
蔡军锋	M
樊淦超	M
贾昱琦	F
刘佳薇	F
吴兵兵	M
李威	M
陈斌	M
秦康	M
杨丰	M
胡赛飞	M
郭志刚	M
李紫豪	M
朱玉泉	M
龚海东	M
马永博	M
杨伟东	M
王维阳	M
黄永幸	M
王威	M
张福位	M
韦添宝	M
万一东	M
杨静辉	M
冯壮壮	M
谢峰	M
杜彭玉	M
李兴	M
郑聪聪	M
陈洪斌	M
黎武	M
沈佳丽	F
李震	M
农丹丹	F
张炳城	M
高露	F
李水秀	F
胡新语	F
文伟宇	M
林培俊	M
花向东	M
高翔	M
张雪	F
陈丹彦	F
项生逵	M
石瑞雪	F
李宏杰	M
田茂飞	M
董佳丽	F
周倩虹	F
袁兆欣	M
徐俊峰	M
李祯	M
丁凯	M
唐泽程	M
柳志鹏	M
刘楠	F
卞秀明	F
王怡	F
吴国苹	F
姚付峰	M
谢宇	F
陈涛	M
朱森权	M
魏东方	M
陈仟仟	F
苏子俊	M
曹德华	M
李茂杰	M
王思丹	F
陈杰	M
林生	M
孙杨丹	F
刘子晏	F
高启阳	M
肖伊雪	F
龙佩瑶	F
厍广智	M
刘鹏飞	M
张健	M
万洪周	M
杨祥英	F
皮见国	M
肖梦伟	M
李慧娟	F
李胜娜	F
董敏敏	F
董恒河	M
杨刚	M
修勰	M
乔金豪	M
韩婉春	F
门天豪	M
袁嘉迪	M
项天戈	M
罗利锃	M
陈俊贤	M
贺奥佳	M
李波	M
马俊	F
赵杰	M
黄琴	F
洪玲	F
刘金亮	M
吴福权	M
李庆	M
刘彦超	M
梅林	M
钱玉萍	F
赵登辉	M
邱林海	M
陶辅星	M
王法鑫	M
吴慧建	M
许庭赫	M
魏朝元	M
汪聪	M
许再莲	F
杨云和	M
徐志勇	M
李家洪	M
孙小玲	F
孙红琴	F
郝流华	M
尚姚红	M
郑建杰	M
陈怱怱	M
余超波	M
吴浩	M
林桐生	M
徐钰婷	F
刘宇	M
王雪	F
张红涛	M
叶飞鹏	M
王金秋	M
吴东山	M
金秀萍	F
马檬	F
陈小洪	M
陈静华	F
孙金尚	M
张榕卿	F
曹云	M
李雪健	M
王清薪	F
任家杰	M
程菲	F
夏俊杰	M
黄文杰	F
何嘉伊	F
王嘉一	M
黄尚鸿	M
王跃国	M
李巧	M
常国勇	M
徐安津	F
李敬业	F
容芳	F
李志浩	M
朱科欣	F
朱俊洁	F
陈贵浪	M
胡兴钱	M
钟长辉	M
张明倩	F
陈禹	M
曾炬	M
李作敏	M
杨露	F
杨赛	M
张徐萍	F
胡立秀	F
温荣	F
万文霞	F
徐樱	F
李敏	M
朱晓维	M
刘文芳	F
程云龙	M
俞海奇	M
姜雅男	F
余孝芳	F
王首恒	M
肖林丽	F
赵小娜	F
张琦	M
刘九齐	M
骆悠悠	F
吴飞	M
王兴成	M
傅展鹏	M
魏斯琪	F
有芬	F
李君	F
胡永锋	M
丁思尹	F
王靖懿	F
张靖	F
郭鑫慧	F
赵燕	F
邵乃伟	M
王娟	F
李威	M
王维娜	F
刘心怡	F
陈少春	M
汪伟芳	F
黄琴	F
童晗英	F
王辉辉	M
陈佳杰	M
李晓	F
陈志婷	F
周天次	M
丁江龙	M
武亚勇	M
余珍勇	M
张贵先	F
牛垒	M
何小敏	F
黄艺婷	F
陈新辉	M
王长胜	M
邢善飞	M
黄通香	F
龚发岭	M
张庆隆	M
王科龙	M
高宝宝	M
陈文平	F
朱鹏斌	M
柏基婷	F
娄炳波	M
徐挺	M
杨建军	M
浦仕宇	F
刘雅	F
陈志华	M
邓帅	M
张庆祥	M
朱春红	F
郑国松	M
陈紫扬	M
张佳	F
李中成	M
钟浩杰	M
王春波	F
罗春英	F
戴乐刚	M
郑东明	M
杨琳	F
张婷	F
李雯	F
张彤	F
乔祥飞	M
尤霄云	F
曹辉	F
杨庆	M
宁沛	F
章程	M
王森海	M
周继科	M
田喆	M
王雪莹	F
陈红娟	F
吕华清	F
周建何	M
周华玲	F
杨浩	M
周龙昆	M
郭亮	M
刘磊	M
王震	M
郑嵩曦	M
韩贵超	M
肖鼎狮	M
才秋平	F
潘树伟	M
李世民	M
石丹露	F
张昫	M
方鹏飞	M
陈青平	M
方强	M
佘明敏	M
李燕	F
郑星星	M
罗梦玲	F
张丽	F
董西梅	F
黄书和	M
王为	M
崔理刚	M
陈华娟	F
叶米敏	F
高少华	F
朱兰芝	F
王燕	F
田恬	F
李建蕊	F
彭佳丽	F
彭志成	M
蔡爱平	F
黄晓静	F
周斌	M
陈伟	M
徐慧	F
黄焱	F
黄永昌	M
赵武超	M
张吉飞	M
付见博	M
张鹏涛	M
陈红平	F
胡聪聪	M
张骙	M
李彦平	M
王旭升	M
田苗苗	F
侯俊	M
王丽2	F
陈小芹	F
罗桂朋	F
郑伟娟	F
段巧丽	F
黄彩金	F
吴艳	F
田明星	M
郁雨虹	F
包辉	M
王伟楠	M
杨吉森	M
刘斯	M
徐延朝	M
孔精勤	M
刁卫国	M
蒋楠	M
黄莉	F
严裕狄	M
杨爱民	M
王成	M
郭莉	F
于家鑫	M
丁建华	M
袁磊	M
欧阳伟华	M
黄明亮	M
吕旭康	M
李哲	M
孔真真	F
周航	M
祝明顺	M
牛贺	F
罗蓉	F
杜媛媛	F
张春杰	M
郑一平	M
卢佳敏	M
许文丽	F
贲庆波	M
尹良秀	F
魏梁秀	F
欧春浓	F
马立斌	M
王骏	M
熊丽景	F
戴光友	M
陈咏	M
陈宇	M
梁金华	M
杨宁	M
徐婷	F
徐文雪	F
陈琼伟	F
苏娜	F
齐素敏	M
严岳玲	F
陈向阳	M
梁明志	M
贺永生	M
张伟	M
白金洋	M
李枝洋	M
黄云杰	M
杨宇林	M
郭喜悦	F
龙吟	M
李龙飞	M
方钦	F
王文明	M
徐明杰	M
张刘子叶	F
陈云华	M
车志强	M
汪敏涛	M
康亚宇	M
纪玉凤	F
曾华巧	F
夏兴旺	M
王娅敏	F
李瑞	M
孟义	M
贾超	M
施琳	F
郭东洋	M
卓雨诺	F
胡晓红	F
苏鑫朋	M
代琴	F
邹志红	F
李本利	M
阮茶花	F
胡家瑜	M
江雪青	F
奚花芹	F
孙妙意	F
徐凤娥	F
童晨灿	M
胡昌伟	M
李静雅	F
王振英	M
陈志琴	F
田进	M
王宏波	M
李海迪	F
李猛	M
李成贤	M
马春曦	M
端芮	M
金子孝	M
张茜	F
任甜	F
罗欣	M
陆永良	M
于济宁	M
许宏刚	M
刘芳	F
董赛双	F
杨建国	M
李博	F
李云伟	M
黄美习	M
姜晓宏	F
吴浩萍	F
孙宁	M
刘慧	F
商粟	F
胡安琪	F
张帅举	M
林强强	M
安小超	M
李琦	M
杜桥月	M
符书镇	M
党永佳	F
岑毛	M
罗如想	M
熊运已	M
李玉琴	F
曹华涛	M
程丹丹	F
江秋霞	F
袁浩淳	M
邓建森	M
方英	F
郭明明	M
竺友民	M
张昊贝	M
王秀秀	F
雷祖宴	M
祝贵花	F
刘嘉文	M
汪广闻	M
陈驰	M
谢飞祥	M
谢艳超	M
叶建国	M
朱张露	F
陈波	M
水玲玲	F
周莹	F
郭秀秀	F
凌先森	M
周厚宾	M
孟祥芳	F
戴俊	M
苏宝宽	M
魏永闯	M
段伟	F
冯旭东	M
陈辉	M
陆学文	M
陈浩	M
何健	F
彭雪琼	F
王飞艳	F
谭明翰	M
周茹	F
姚梦霞	F
潘盈盈	F
闵道伟	M
罗永娥	F
王川江	M
李殿	M
陈雅萍	F
朱丽霞	F
孙宇	M
王冲聪	F
杨妙	M
王春波	F
卜俞宾	M
张平建	M
陈钦超	F
刘志瑞	F
陈慧	F
蒋浩	M
甘礼文	M
赵宇	M
张晓英	F
侯正	M
周雪娜	F
彭常拯	M
周烨	M
郑红枫	F
任素君	F
张红	F
冯慧华	F
黄德根	M
柴小芬	F
柴丽丽	F
杜永鑫	M
蒋志英	F
骆燕波	F
周飞飞	M
赵晶晶	F
刘贤君	M
张全	M
李井玉	F
王晓	F
卢桑	F
张洁	M
黄步宁	M
侯丽颖	F
余彬	F
沈祝怡	F
黄知莲	F
容荣	F
蒋迪圆	F
刘丽萍	F
王永堂	M
牛飞红	F
张振东	M
徐俩慈	M
朱龙	M
陈莉	F
周叶菁	F
叶陈鸿	M
龚正坤	M
端家键	M
潘莹	F
肖云平	M
汪发威	M
李风雷	M
张吉军	M
张杰建	M
庄长松	M
杨俊涛	M
王琼	F
尹添乐	M
李佳	F
潘霄	F
钱美芳	F
陈丽芬	F
夏杰飞	M
牛旭	M
严庚	M
代宝	M
刘志平	M
倪祎绮	F
殷蕾	F
江雪峰	M
廖水畅	M
邓哈如尼	M
王俊濠	M
李红卫	M
张青松	M
闫龙龙	M
杨研	M
邱强	M
陈晨	M
聂锦泉	M
李家亿	F
杨建民	M
杨杭	M
闫大彬	M
卿毅	M
陈海豪	M
汪小梅	F
伏婷	F
赵鹏辉	M
杜启琦	F
侯志强	M
赵文华	M
潘修存	M
赵彤	M
辛昊	M
刘增祥	M
杨涛	M
贾志伟	M
张军	M
常成	M
王重斌	M
黄挺	M
张建伟	M
焦碧英	F
谢石秀	F
张詩涵	F
张婷婷	F
陈沛霖	M
刘志	M
徐云骑	M
刘杰	M
吴樱	F
武金娜	F
林中石	M
林铭	F
章妤	F
章劲松	M
陈娟	F
段依沙	F
王斌强	M
王愈寒	F
禤佩贤	F
陶冠君	M
韩曜宏	M
陈东媛	F
夏红	F
董梦雨	F
顾晓雷	M
李力南	M
徐细梅	F
崔红斌	M
管婧	F
刘杰	M
陈亚佩	F
毛犇	M
程小莹	F
陈袁波	M
顾宝祥	M
黄珍	M
李彬	M
颜强	M
郭金柱	M
马磊	M
杨志虎	M
孙玲玲	F
姚帝安	M
许莎莎	F
鲁国华	M
王帅	M
朱猛	M
方明浩	M
毛凌晓	M
易志坚	M
王来鹏	M
蒲永前	M
秦盼	F
陈涛	M
陈健鑫	M
赵磊	M
芒吉锋	M
罗倩倩	F
杨振	M
黄焕申	M
陈冬彬	M
武保	M
钟秋	F
刘检平	M
姜梦茹	F
韦抗生	M
张贤	M
霍宇娟	F
凌相勇	M
李盈	F
王情	F
李宁宁	F
槐引引	F
李宁	M
张圣贤	M
陈凯	M
詹辉凡	M
杨岗	M
邱泽栋	M
龚霞芳	F
李志佳	M
侯仁翔	M
吴侃益	M
陈巩凡	M
邓兵	M
胡涛	M
马岐	M
施兴雨	F
蒋美君	F
俞维维	F
姜文梅	F
尹德利	M
俞珍芝	F
袁萌	F
赵东浪黑	M
周军	M
叶喜春	M
陈焕泽	M
康献锋	M
刘海波	M
刘仕银	M
鲁兰	F
胡燕	F
刘杰	M
朱秋燕	F
曾萍	F
吴洁	F
邬银虹	F
王静静	F
惠田野	F
钱佩	F
陈金晶	F
童雪倩	F
任鹏宇	M
任海平	M
何靖宇	M
陈静	F
乔文明	M
王秀金	F
陈波立	M
吕华斌	M
彭强	M
柏冀	M
朱瑜亮	M
姜海平	F
张小英	F
倪前春	M
刘玉会	F
符方定	M
邬佩芬	F
丁涵	M
欧阳勇	M
余鑫	M
陈方略	M
朱奥辉	M
曹青	F
祁晓	F
贾昌林	F
刘卉萌	F
李鹏飞	M
李小莉	F
李德云	M
沈青青	F
邓文	F
伍世涛	M
陶端镇	M
吴江永	M
韩琳霞	F
孟军	M
万云松	M
袁顺礼	M
项新晨	M
李修治	M
王鲁凯	M
李春雨	M
张虎城	M
罗德朋	M
刘红利	M
李海宁	M
李崧	M
丁泽峰	M
尚建球	M
陈鹏	M
周志福	M
龚学成	M
罗建	M
卓国栋	M
陈娜	F
庄奇	M
雷梦雪	F
沈兆强	M
刘敏	M
王权	M
梅早顺	M
张金枫	F
李红琳	F
金莉丹	F
王健	M
郑锦涛	M
安旭东	M
朱浩峰	M
钱国萍	F
黄专	M
王成义	M
郑纲武	M
张平	M
罗薇	F
李强	M
黄灿	M
锁应调	F
高吉林	M
张荣峰	M
杨阳	F
徐振华	M
侯云彪	M
尹亚茜	F
黄彭	M
王胜	M
吕坚	M
苏天爱	F
王若阳	M
戴晨昕	M
赵朝阳	M
李明杰	M
雷微	F
陈丽洁	F
俞美丽	F
王天伟	M
宋佳	F
马志海	M
更卡东知	M
邬燕红	F
熊智明	M
阳柏凤	F
王月月	F
王磊	M
韩莹莹	F
徐洁	F
邹志炜	M
李敏	M
宋志银	M
刘超	M
常占峰	M
覃仕君	M
刘慧敏	F
王宇	F
吴贤江	M
郑东旭	M
蔡玲玲	F
黄承妹	F
姜华	M
徐熙辉	M
彭明献	M
陈峰	M
朱爱国	M
刘晓慧	F
江春杨	M
马素华	F
汪维波	M
罗一斌	M
刘金鸿	M
胡文佳	F
钱晨窈	F
曹路阳	M
姚海英	F
周姜静芝	F
朱云双	F
汪妍	F
林茜茜	F
王鹤	M
刘周阳	M
舒兰	F
伍杰伟	M
赵兰青	F
万强	M
楼俊莉	F
吴霖杰	M
索秀娟	F
杨振虎	M
王曙光	M
王修亮	M
徐兵	M
左水根	M
陈乐勇	M
李江森	M
张宁湘	F
毛丹	F
黎茂佳	M
马热给不	M
胡钒	F
章臣荣	M
李海荣	F
李再平	F
吕婷婷	F
潘家洁	F
朱冬冬	M
郑家健	M
周曼	F
邓秋兰	F
王征宏	M
李小娇	F
邵笛	F
王建国	M
卢元平	M
赵树霖	M
周尧	M
邱海霞	F
徐浩磊	M
杜喜梅	F
王彬彬	M
金娇娇	F
张庆奎	M
杜章庆	M
李小山	M
盛鑫	M
周世杰	M
蒋磊	M
任行学	M
郑雨忱	F
闫大武	M
张琦	M
张佳豪	M
韦银姬	F
周程建	M
王蓉	F
陈楚琪	F
王猛	M
王超博	M
张嘉奎	M
马云杰	M
张媛媛	F
李悦	F
樊伟涛	M
吴相蓉	M
曾令豪	M
宋维娜	F
袁丽	F
欧阳玉华	F
李天琪	F
秦志文	M
王文军	M
胡树林	M
曾思洁	F
刘洋	F
陈茜	F
程茂武	M
史云宏	M
叶超琴	F
王若馨	F
张耀文	M
刘润南	M
马招梅	F
叶伟	M
徐黎	M
仙雪亚	F
火艳丽	F
毛紫微	F
郑丽华	F
李嘉泉	M
王亮	M
陈涛	M
陈柯宇	M
刘鹏	M
陈云拼	M
宋林林	M
武浩	M
陈乐	M
陈晓芳	F
文林林	M
罗娅萍	F
苗称心	F
隋晓晓	F
莫键	M
李玮	M
章男	M
钱培	M
朱文杰	M
赵峰	M
童勇扬	M
罗美林	F
吴诗卉	F
马小爱	F
张松林	M
张玉	F
李江红	M
符妃妃	F
王蓉	F
刘岩	M
项敏超	M
张才彬	M
范紫娟	F
励海良	M
方乐华	M
陈红名	M
胡倩倩	F
王芳芳	F
胡伙秀	F
夏媛	F
丁玲	F
江宏磊	M
陈婉蓉	F
刁元华	M
陈琛	F
金玉洁	F
朱笑君	M
高亮	M
徐磊	M
王丽霞	F
贺媛媛	F
张登忠	M
胡杰	M
郭凤	F
杨思强	M
冯伟	M
廖涌成	M
费佳薇	F
杨兰真	F
白少新	M
白侠	F
李文峰	M
何胜富	M
康忠强	M
林钊	M
杨倩	F
赵雨洁	F
许岚	F
邹阳柳	M
朱东	M
肖俊	M
朱娟	F
卓秀芝	F
高平	F
王宇环	F
李文冬	M
郁道云	F
杨玉琴	F
沈巧珍	F
张国栋	M
王磊	M
严萍萍	F
刘琼	F
周文锦	M
刘良华	M
周汉福	M
蒋跃红	F
胡慧敏	F
张潇	F
黄涛	M
王辉	M
王阳阳	M
董正琴	F
张浪	M
林永兴	M
陈娟	F
陈建强	M
于泽	M
王绍林	M
吴鸿悦	F
黄钰	F
赵俊成	M
陆祎玥	F
刘建平	M
易飞	M
李洪娜	F
陶茂春	M
余丽花	F
熊琪琪	F
唐丹	F
张文芳	F
陈国	M
张金梅	F
程林	M
胡庆敏	F
吴小芳	F
伍航	M
王冬儿	F
周成成	M
李奇	M
唐伯年	M
向丽萍	F
王海国	M
王钊	M
马程旻	F
林昂	M
王树强	M
徐新鹏	M
吴纳斯	F
舒幼琴	F
马卫	M
陈叶	F
胡永翔	M
付强	M
罗源	M
曾路江	M
李佳浪	M
朱仕富	M
龚小媛	F
谢长星	M
余明艳	F
王宁	F
陈良兴	M
马成祥	M
于璇璇	F
徐光旭	M
刘异木	M
蔡文	M
詹正	M
赵正平	M
赵彦欣	F
凌杰	M
王甲	M
李丹	F
竺巧琴	F
张正好	M
李凯玲	F
林金海	M
王敏懿	F
王超	M
孙伟	M
曹慧慧	F
赵龙	M
覃佳锋	M
韦建筑	M
李兴成	M
项小贞	F
陆浩	M
陈翔	M
许强	M
于陶	M
周京	F
孙琰	F
靳焱	M
沈华泽	M
唐旭明	M
冯钰	M
王文	F
祝柯奇	M
顾煜	M
李胜	M
康云霞	F
王雯	F
施彩云	F
李支宁	M
陈钟芳	F
庹宇	M
曹锦旺	M
王壹隆	M
王志波	M
谢晨光	M
李春辉	M
徐信明	M
王奇	M
崔琴	F
宁春燕	F
赵悦	F
杨全	M
季照洋	M
王成文	M
朱堂维	M
余伟	M
徐涛	M
龙蓉	F
肖尧文	M
贺家琼	F
王鑫歆	F
徐菲	F
李楠楠	F
杨澜	F
刘倩	F
李响	F
徐玮辰	M
葛文	M
陶信峯	M
何帅	M
代小庆	F
万斌荣	M
熊国华	M
曹阳	M
谭付彬	M
沈麓祎	F
钱路希	M
闫侠辉	M
苏发强	M
韦长胜	F
汤萌	F
李作美	F
贾照龙	M
张丽芳	F
徐小伟	M
周惠薇	F
潘雅维	F
叶君	F
申书晨	M
李古月	F
赵英剑	M
沈家红	F
王胜	M
张晓东	F
邓志强	M
汪华珠	F
赵黎明	M
汪俊	F
吴维娜	F
朱周飞	M
王延慧	F
徐国宏	M
温晨光	M
谢可	F
王鸿基	M
陆宁	F
巢祺	F
王江林	F
黎玫	F
魏小花	F
徐辰	M
陈佳佳	F
李红艳	F
李玲娜	F
余明	M
李华丽	F
汪苗苗	F
黄博文	M
罗超	M
王燕	F
段秀丽	F
陈志恒	M
曾文忠	M
沈宇力	M
杨志彪	M
周海峰	M
夏孝进	M
刘长城	M
张兴万	M
龙念科	M
王阳	M
朱自强	M
富琳琳	F
郑莹莹	F
张晓许	M
李涵熙	M
何柳	M
何正宇	M
朱景	M
罗思鳌	M
许文涛	M
刘维	M
刘梓康	M
冷骏杰	M
朱崎峰	M
王鸿浩	M
周旭斌	M
王震	M
沈鑫芝	F
李友梅	F
赵娟	F
张鸿燕	F
宋忠国	M
谭国荣	M
谢流创	M
李仁望	M
罗永祥	M
肖艳春	F
王祖红	M
韦康照	M
王爱强	M
王玉凤	F
李华燕	F
许龙刚	M
贺斌	M
李枫林	M
陈文星	F
李长浩	M
李忠安	M
樊震	M
关钰霖	F
蒋仕君	M
洪吉祥	M
巢佳豪	M
戴高明	M
罗帅康	M
彭庆	M
朱文广	M
江桂民	M
李明远	M
彭立鑫	M
李娜	F
马峥	M
陈邦超	M
王亚龙	M
潘婷	F
邬水娜	F
郭梦蝶	F
罗云	M
张联波	M
罗涛	M
祝勇	M
唐坤富	M
王许	M
谷鹏菲	M
杨仕超	M
王海宾	M
徐立刚	M
芮晓兰	F
李士桐	M
王军	M
张秀霞	F
皇甫子超	M
彭熙晨	M
石应真	M
杜新宇	M
徐小焜	M
王银娟	F
黄雅文	F
刘浩延	M
曹佳豪	M
黄铭	M
黄宇	M
许文博	M
余创	M
朱嘉颖	M
张文杰	M
龙标	M
张丽	F
俞超	M
黄杰	M
印晓晓	F
陈鑫	F
曹阳	F
谢红军	M
颜小芳	F
鄢强强	M
高环	F
翟培江	M
周宏	M
高新娥	F
刘银森	M
张磊	M
付秋桃	F
黄银会	F
陈龙	M
余雪	F
杨阳	F
刘牧东	M
韦永辉	M
杨雄	M
高菲菲	F
朱东梅	F
严佰英	F
张三华	F
曹江	M
孙兴望	M
徐灿东	M
仇国强	M
彭吉康	M
吴撼宇	M
孙智阳	M
湛卓	M
廖攀	M
曹丹	F
黄令	F
李德爽	M
顾旭东	M
金杰	M
张德亮	M
李重	M
周洋	M
卢仕春	F
汪小燕	F
任茂瑛	F
邵佩芬	F
贺恒凯	M
吴晗	M
王浩	M
卢金方	M
张明庆	M
赵志元	M
王亚莲	F
朱国财	M
郑俊辉	M
黄建东	M
闫素琴	F
熊敏	M
谢湘群	F
胡蝶	F
徐秋菊	F
廖招娄	M
廖勋康	M
甘乐	F
徐荣	F
吴爽	F
龙璇	F
李宇航	M
舒佳羽	F
许妙	M
舒适	M
傅立宏	M
李添夫	M
刘育飞	M
李小兰	F
陈华睿	M
李洪明	M
迟红岩	F
宋辉	M
赵永波	M
罗峰	M
杨宏平	M
吴昊	M
马小龙	M
卢方成	M
熊新文	M
瞿辉阳	M
李虎	M
徐艳苹	F
李青	F
何晶晶	F
周福星	M
陈正军	M
吴亮红	M
李欢	F
傅定刚	M
奉小玲	F
苗兴源	M
李根	M
翁昊楠	M
林贵飞	M
董勇	M
熊颖兰	F
杨晓羽	F
吴健豪	M
黄天赐	M
徐晨曦	M
叶顶	M
康佳俊	M
周嘉豪	M
李桑屹	M
伏海鑫	M
梁超磊	M
杨震东	M
高照双	M
马航宇	M
赵金木	M
沈淑颖	F
严美娣	F
赵文婷	F
马晓兰	F
曾佳宁	F
蒋雪娇	F
缪薇	F
刘展宏	M
付应攀	M
邹威	M
张松威	M
宋艳元	M
杨凤凤	F
杨建民	M
朱红艳	F
兰芳林	M
周佳怡	F
王志锋	M
刘星星	F
白兴鹏	M
刘玉松	M
刘小佩	F
张艳艳	F
姜益君	F
陈小璐	F
曾梅香	F
王莉娜	F
陈贝贝	F
任文静	F
胡成学	F
黄金瑞	M
朱冬玲	F
胡江浩	M
林泓志	M
陈掬琦	F
陶海艳	F
翟海涛	M
郑虎强	M
王楠	M
周蓉	F
周小花	F
熊灯香	F
汪洋洋	M
张华伟	M
张绍刚	M
周德龙	M
徐阳佳	M
曹小余	F
叶海明	M
程春强	M
周丽平	F
葛振兴	M
费思远	M
李承乐	M
朱天娥	F
周肖雅	F
王锡丹	F
夏飞	M
徐宏飞	F
刘珍	F
王琪瑶	F
张秀荣	F
董建丰	M
朱凤霞	F
万雪	F
张平	M
叶成	F
李松斌	M
何涛	M
宋连芝	F
曹光争	M
陈昭祺	M
龚泽宁	F
支波	M
张洁	F
涂洪兵	M
刘钰	F
王嘉明	M
边军香	F
蒙连香	F
郭秀程	M
周月娥	F
邓鈺燕	F
张俊平	M
孙佳	F
雷金伟	M
耿传丽	F
应镐阳	M
马康	M
郑为广	M
王锡容	F
吴小群	F
万常萍	M
陈贤军	M
王晓伟	M
闻婷	F
刘赛兰	F
刘瑞松	M
朱振天	M
龚怡兰	F
梁想	F
杨贡荣	M
郑洁	F
冷宝才	M
申立胜	M
胡清华	M
杨泽煊	M
刘振波	M
刘明英	F
谭青妹	F
苏宗涛	M
鲁晓阳	M
张俊生	M
刘新建	M
刘敏	M
孙博毅	M
张亮	M
陈欣嘉	F
王林杰	M
熊正慧	M
雷亚梅	F
杨爽	M
钟启鹏	M
侯苗苗	M
雷亚倩	F
肖艳婷	F
马怒给业	F
杨志彬	M
吴帆	M
黄燕	F
罗国庆	M
江浩军	M
于可新	F
陈丽卡	F
王强基	M
吴刚	M
沈叶	F
李文佳	F
袁鑫	M
林传菊	F
崔锡忠	M
吴鸿	M
胡家豪	M
班庭锋	M
熊美丽	F
聂义松	M
周红	F
柳志德	M
安旭	M
杨锐	M
李丹阳	F
裴晚露	F
罗斌	M
李雪	F
胡曼芳	F
吴建伟	M
汪心涛	M
张楠	F
张中强	M
彭彦军	M
杨欢	F
李群双	F
吕佳倩	F
蔡丽霞	F
吴锡君	M
卜海波	F
谢豹	M
李小伟	F
刘龙伟	M
何春女	F
周岩山	M
邓伟立	M
简相龙	M
庞云飞	M
汪建	M
刘伍喜	M
张玉霞	F
王辰	M
陶绪坊	M
戴青	F
彭晶	F
李艳	F
杨欣丽	F
毛瑞阳	F
沈逸斌	M
宋悦	F
李艳琴	F
马裕露	M
马太力哈	F
张宵	F
乔宁	M
邱杨扬	M
杨洁茹	F
陈玲	F
章田	M
龚鲜梅	F
陈智	M
李欣熹	M
王芳	F
吴涛	M
李春阳	F
徐滨	M
何成国	M
田亚博	M
李聪辉	M
薛玉发	M
袁强强	M
代文越	F
员鸿飞	M
黄菊	F
郑优优	F
马苏木	F
许佳婷	F
李永亮	M
孙鑫	M
武梦茹	F
陈涛	M
彭清明	M
王家辉	M
施松章	M
曹巍	M
徐振龙	M
吴素梅	F
徐三蚌	M
陆金玲	M
高丽	F
任海龙	M
陈金矿	M
左乾	M
施华云	F
邱杨华	M
余加刚	M
夏荣来	M
胡强英	F
马阿舍	F
熊刚	M
孙海南	M
梁笑萍	F
康瑞欣	F
宋平华	M
邱静莉	F
陶茂份	M
李群	F
金耀华	M
翟晓册	F
叶淑敏	F
赵家震	M
马木亥买	M
陈长武	M
潘蓓佳	F
郭建平	F
吴俊超	F
王洁	F
陈古平	M
陈海莲	F
马牧原	M
张致峰	M
郝镜凯	M
鲁维新	M
王小凤	F
潘鹏	M
徐光	M
陈意蓉	F
程静	F
张春玉	F
张豪豪	F
张龙洲	M
徐细闻	F
王思佳	F
刘秋凡	F
崔赛凤	F
张振飞	M
马锁飞也	F
熊路路	M
王林娜	F
许景禄	M
万川	M
张春芬	F
刘永超	M
李亚北	M
王勇	M
张浩	M
王青林	M
李嘉辉	M
谢盛武	M
胡丽	F
熊红艳	F
陈赞	M
蔡琴琴	F
王纯	F
周俊	M
王丹	F
徐倩	F
余琴	F
王晓东	M
郭文涛	M
鲁宜旺	M
倪银漂	F
鲁雪利	F
王磊	M
肖钱峰	M
姜智明	M
施良	M
杨月美	F
姚吉莎	F
胡慧霞2	F
竺珊珊	F
孔超越	M
赵威	M
李自明	M
李杰	M
谭志亮	M
王港	M
黄龙飞	M
李洪富	M
谭发才	M
陈翰笙	M
陈刚	M
李梦梦	F
张金玉	M
屠金波	F
潘雅茹	F
陶秀琴	F
缪小银	F
郤江浩	M
王宏波	M
张彦彦	F
李海星	M
孙海潮	M
马超	M
余菱菱	F
谭国根	M
孙乐蓉	F
陈香波	F
勒细花	F
吴芳强	M
刘春红	F
王东亚	M
王德莫	M
王福军	M
蒋红志	M
干伟峰	F
杨懿	M
黄支密	M
李广宁	M
莫琪斌	M
赵志强	M
李露娜	F
周号一	M
吴建	M
杨辉	M
黄贤彪	M
沈燕	F
何旭丹	F
熊家全	M
刘勍	M
陈阳	M
吴骏	M
张廪	F
高琢	M
汤康	M
周峰	F
唐华	M
张建飞	M
王梦玫	F
梁勇	M
靳志坤	M
高佳艺	F
龚柏明	M
宋秀丽	F
吴瑶瑶	F
陈凯威	M
许荣峰	M
朱烜均	M
池泽源	M
张俊宽	M
李雨霜	F
方仁豪	M
胡高峰	M
王梓强	M
周加伟	M
冯军旗	M
郭有权	M
韩利娜	F
金静	F
刘韦君	M
刘飞飞	F
李彩红	F
杨秋建	M
卓越	M
陶金玲	F
姜润耕	M
吴松	M
庞雪娇	F
孙艳美	F
熊小红	F
李敦	M
陈一波	M
邵碧娇	F
孙嘉麟	M
钟永前	F
石朝建	M
周彪	M
张雷	M
巴栋阳	M
季姣	F
周杨玉	F
瞿备提	F
李家质	M
王文滔	M
张强	M
孙龙	M
陈杨	M
程舒	F
刘玲	F
孙晓菊	F
姚星辉	M
罗倩	F
陶亚俊	F
郭文斌	M
周中军	M
李春荣	F
邓美侠	F
李培	M
吴雪芹	F
张晗1	M
陈晶晶3	F
刘青青	F
蔡立维	F
刘芳	F
周聪	M
梁恒	M
程伟	M
赵博	M
汪凯	M
夏杏钗	F
蒋志浩	M
谢红先	M
朱丙臣	M
朱子墨	M
贺波波	M
崔家俊	M
俞金卫	M
马心雨	F
马红兰	F
李昂	M
姚明国	M
曹亮	M
吕浩	M
叶宇晨	M
胡建新	M
杨奇达	M
丁玲玲	F
付孟	M
于静	F
刘朋	M
杨玫	F
危正义	M
张小云	F
陆玲	F
刘凯	M
芮富康	M
李素珍	F
黄志平	M
耿龙	M
刘国锦	M
韩大宝	M
张硕	M
郭香霞	F
吕霞	F
陈亚妮	F
侯奥林	M
邓泽新	M
孙一燕	F
陈剑芳	F
胡磊	M
胡敬甲	M
陈诗源	F
乐如意	F
殷韵	F
韩冰冰	M
徐云	M
赵洁	F
章回春	M
张昆	M
陈垒斌	M
冉宇欣	M
杨玲虹	F
马亮亮	M
林森	M
项佳丽	F
傅周丽	F
陈洪生	M
姚寅彬	M
吴茂凯	M
韦祥	M
占小红	F
徐倩倩	F
胡昊	M
王洪莲	F
张振	M
管昌	M
沈忠义	M
周鹏	M
陈建荣	F
陈永建	M
张晓欣	F
罗双	M
童璐璐	F
汪黎黎	F
熊焕洋	M
金燎原	M
谢缘圆	M
连潇阳	M
李灿	M
曹玉蓉	F
曹一繁	F
杨静	M
桂栋栋	M
沈金梅	F
贺永泽	M
王小周	M
王习勇	M
许文英	F
武兵	M
贺世杰	M
吴涛	M
胡双进	M
杨亚茹	F
李国	M
赵凯冰	M
袁卫萍	F
李云	F
王素玲	F
李玲玲	F
宋倩男	F
钱钿畑	F
朱文苑	F
郭根华	F
胡英婵	F
盛震	M
姜雪君	F
邓新鹏	M
李萍	F
魏佳佳	F
赵开取	M
赵智	M
罗方	F
王康	M
曹丹凤	F
励杰	M
杨恒兵	M
冯狄福	M
乌青浩	M
黄晓丹	F
杨德名	M
吴文成	M
郑敏红	F
何磊	M
杨棕林	M
刘佳媛	F
吴家旭	M
张干	M
陈婷欢	F
楼华杰	M
张艳玲	F
王力	M
向林锋	M
时兆龙	M
崔潘乐	M
孔玉进	M
张彬	M
戴梦莎	F
张迎亮	M
朱书记	M
吴青	M
林秋宁	F
路莹	F
王维	F
罗运龙	M
范增淋	M
付志鹏	M
王子豪	M
龙雨昌	M
厉材	M
谢祥	M
卢延涛	M
赵望	M
张智勃	M
余长春	M
何超超	M
陈正龙	M
朱丛逸	M
薄红梅	F
朱丽琴	F
孔维群	F
胡杰	M
杨燕	F
刘义	M
杨欢丽	F
翟志强	M
盖聪	M
李辉	M
丁美玲	F
李彤博	M
许赛	M
万伦	M
田钦	M
李小龙	M
李江	M
傅俊敏	M
马翔	M
易高新	M
旷英杰	M
杨高阳	M
张彬	M
吴迪	M
刘畅	M
吴新宇	M
周澍琦	M
彭张	M
葛超	M
许博	M
杨彦义	M
贾常燕	F
廖振宇	M
董瑞	M
安宇辉	M
周欢	F
王菊平	F
董刚	M
马关琴	F
喜向荣	M
雷石婷	F
申迪凡	M
吴凤莲	F
徐燕燕	F
胥锦林	M
黎勇	M
倪鹏	M
谢晓强	M
黎威	M
巢珍	M
刘星宇	M
易欣	M
彭翔宇	M
王雨金	M
李玉芳	F
程峰	M
刘俊杰	M
李双双	M
吴蕾	M
龙彬	M
吴浩	M
熊明	M
徐大妹	F
张琴	F
雷一升	M
雷希	M
施红涛	M
刘航	M
程玲英	F
张龙琦	M
夏治军	M
宋文杰	F
张驹	M
季迎静	F
孙幸旭	M
董向鹏	M
马慧如	F
张兴志	M
金国福	M
白雪	F
赵双	M
张伟	M
敖丽亮	M
陈薇娜	F
徐海龙	M
熊辉	M
邹结贵	M
李冬香	F
钟宾如	M
张建兵	M
廖小勤	M
李苏	M
杨扬	M
魏江涛	M
夏文新	M
熊安锋	F
李文文	F
张佳星	F
刘艳林	F
涂斌	M
严波	M
唐猛	M
王敏	M
熊琪	M
客政海	M
玄兆一	M
李超	M
李硕	M
吴波	F
何跃	M
孙瑞文	M
李小平	F
陈玲燕	F
熊继会	F
谢亭湘	F
杨梦玲	F
李好	M
袁艳琴	F
邓祥彬	M
郑小林	M
钱进	M
孟繁旭	M
龚欣潮	M
彭文强	M
刘博	M
赵薪程	M
吴治远	M
王祝梅	F
杨心雨	M
罗烨	M
吴超	M
左钒	M
黄家豪	M
余思杰	M
李展寰	M
潘言俊	M
陈强	M
兰楚峰	M
奉深	F
邵巧宇	F
孙骏奇	F
廖芊	F
楚嘉仪	F
刘谢	F
徐林	F
马志成	M
张鹏杰	M
廖保胤	M
杜振	M
吕亚鑫	M
马昭师	M
丁海生	M
戴重庆	M
李江峰	M
高晗	M
栾慧慧	F
黄波涛	M
马定美	F
马色力麦	F
王兰兰	F
李龙印	M
王勇超	M
许恩绪	M
唐宇	M
柴士杰	M
马金辉	M
徐建勇	M
赵德钦	M
吴荣斌	M
杨帅	M
